,label,i18nCode,count,fq,start_date,end_date,activity_span
0,"Beauglehole, A.C.","collector.Beauglehole, A.C.",90942,"collector:""Beauglehole, A.C.""",1865,2005,140
1,"Forster, P.I.","collector.Forster, P.I.",64649,"collector:""Forster, P.I.""",1955,2018,63
2,"Hyland, B.","collector.Hyland, B.",57265,"collector:""Hyland, B.""",1952,2008,56
3,"Latz, P.","collector.Latz, P.",51230,"collector:""Latz, P.""",1875,2019,144
4,"Streimann, H.","collector.Streimann, H.",45346,"collector:""Streimann, H.""",1896,2001,105
5,"Elix, J.A.","collector.Elix, J.A.",39702,"collector:""Elix, J.A.""",1878,2020,142
6,"Gray, B.","collector.Gray, B.",35130,"collector:""Gray, B.""",1956,2020,64
7,"Bean, A.R.","collector.Bean, A.R.",34015,"collector:""Bean, A.R.""",1965,2017,52
8,"Blake, S.T.","collector.Blake, S.T.",33031,"collector:""Blake, S.T.""",1846,1996,150
9,"Cleland, J.B.","collector.Cleland, J.B.",32242,"collector:""Cleland, J.B.""",1841,1996,155
10,"Brooker, M.I.H.","collector.Brooker, M.I.H.",30298,"collector:""Brooker, M.I.H.""",1890,2007,117
11,Anon.,collector.Anon.,29949,"collector:""Anon.""",1779,2014,235
12,"Symon, D.E.","collector.Symon, D.E.",28373,"collector:""Symon, D.E.""",1889,2011,122
13,"Cranfield, R.J.","collector.Cranfield, R.J.",28167,"collector:""Cranfield, R.J.""",1941,2015,74
14,"Stone, I.G.","collector.Stone, I.G.",25938,"collector:""Stone, I.G.""",1940,1999,59
15,"Coveny, R.G.","collector.Coveny, R.G.",25486,"collector:""Coveny, R.G.""",1909,2018,109
16,"Phillips, M.E.","collector.Phillips, M.E.",25427,"collector:""Phillips, M.E.""",1902,1995,93
17,"Batianoff, G.N.","collector.Batianoff, G.N.",25371,"collector:""Batianoff, G.N.""",1955,2008,53
18,"Moscal, A.","collector.Moscal, A.",25110,"collector:""Moscal, A.""",1968,2004,36
19,"Clarkson, J.R.","collector.Clarkson, J.R.",23612,"collector:""Clarkson, J.R.""",1930,2012,82
20,"Jones, D.L.","collector.Jones, D.L.",22353,"collector:""Jones, D.L.""",1941,2017,76
21,"Willis, J.H.","collector.Willis, J.H.",21961,"collector:""Willis, J.H.""",1885,1996,111
22,"George, A.S.","collector.George, A.S.",21649,"collector:""George, A.S.""",1898,2016,118
23,"McDonald, K.R.","collector.McDonald, K.R.",19822,"collector:""McDonald, K.R.""",1971,2018,47
24,"Bates, R.J.","collector.Bates, R.J.",19514,"collector:""Bates, R.J.""",1918,2017,99
25,"Purdie, R.W.","collector.Purdie, R.W.",18743,"collector:""Purdie, R.W.""",1960,2019,59
26,"Ising, E.H.","collector.Ising, E.H.",18649,"collector:""Ising, E.H.""",1818,2000,182
27,"Keighery, G.J.","collector.Keighery, G.J.",18312,"collector:""Keighery, G.J.""",1908,2016,108
28,"Lazarides, M.","collector.Lazarides, M.",18170,"collector:""Lazarides, M.""",1935,1992,57
29,"Womersley, H.B.S.","collector.Womersley, H.B.S.",17909,"collector:""Womersley, H.B.S.""",1648,2007,359
30,"Crisp, M.D.","collector.Crisp, M.D.",17661,"collector:""Crisp, M.D.""",1876,2018,142
31,"Kantvilas, G.","collector.Kantvilas, G.",17621,"collector:""Kantvilas, G.""",1963,2020,57
32,"Whinray, J.S.","collector.Whinray, J.S.",17414,"collector:""Whinray, J.S.""",1883,2017,134
33,"Buchanan, A.M.","collector.Buchanan, A.M.",17177,"collector:""Buchanan, A.M.""",1966,2019,53
34,"Hosking, J.R.","collector.Hosking, J.R.",16622,"collector:""Hosking, J.R.""",1966,2018,52
35,"Telford, I.R.","collector.Telford, I.R.",16539,"collector:""Telford, I.R.""",1909,2018,109
36,"Mueller, F.","collector.Mueller, F.",16407,"collector:""Mueller, F.""",1803,1969,166
37,"Chippendale, G.","collector.Chippendale, G.",15753,"collector:""Chippendale, G.""",1900,1998,98
38,"Albrecht, D.","collector.Albrecht, D.",15556,"collector:""Albrecht, D.""",1982,2019,37
39,"Gardner, C.A.","collector.Gardner, C.A.",15039,"collector:""Gardner, C.A.""",1898,2008,110
40,"Eichler, Hj.","collector.Eichler, Hj.",15014,"collector:""Eichler, Hj.""",1863,1993,130
41,"Spooner, A.G.","collector.Spooner, A.G.",14908,"collector:""Spooner, A.G.""",1919,1998,79
42,"Watts, W.W.","collector.Watts, W.W.",14790,"collector:""Watts, W.W.""",1877,2004,127
43,"Cowie, I.","collector.Cowie, I.",14584,"collector:""Cowie, I.""",1966,2020,54
44,"Williams, J.B.","collector.Williams, J.B.",14534,"collector:""Williams, J.B.""",1896,2014,118
45,"Canning, E.M.","collector.Canning, E.M.",14214,"collector:""Canning, E.M.""",1950,2010,60
46,"Constable, E.F.","collector.Constable, E.F.",14027,"collector:""Constable, E.F.""",1848,2008,160
47,"Wilson, K.L.","collector.Wilson, K.L.",13831,"collector:""Wilson, K.L.""",1926,2019,93
48,"White, C.T.","collector.White, C.T.",13698,"collector:""White, C.T.""",1904,2012,108
49,"Davis, R.","collector.Davis, R.",13265,"collector:""Davis, R.""",1911,2018,107
50,"Wilson, P.G.","collector.Wilson, P.G.",13225,"collector:""Wilson, P.G.""",1927,2018,91
51,"Latz, P.K.","collector.Latz, P.K.",13146,"collector:""Latz, P.K.""",1967,2016,49
52,"Bates, R.","collector.Bates, R.",13124,"collector:""Bates, R.""",1912,2014,102
53,"Thompson, E.J.","collector.Thompson, E.J.",13025,"collector:""Thompson, E.J.""",1969,2017,48
54,"Crawford, I.","collector.Crawford, I.",12816,"collector:""Crawford, I.""",1900,2019,119
55,"Stajsic, V.","collector.Stajsic, V.",12813,"collector:""Stajsic, V.""",1900,2020,120
56,"Badman, F.J.","collector.Badman, F.J.",12684,"collector:""Badman, F.J.""",1943,2009,66
57,"Maiden, J.H.","collector.Maiden, J.H.",12611,"collector:""Maiden, J.H.""",1807,2008,201
58,"Boorman, J.L.","collector.Boorman, J.L.",12416,"collector:""Boorman, J.L.""",1856,1992,136
59,"Filson, R.B.","collector.Filson, R.B.",12302,"collector:""Filson, R.B.""",1933,2000,67
60,"Craven, L.A.","collector.Craven, L.A.",12286,"collector:""Craven, L.A.""",1954,2014,60
61,"Johnson, L.A.S.","collector.Johnson, L.A.S.",12249,"collector:""Johnson, L.A.S.""",1906,1998,92
62,"Kenneally, K.F.","collector.Kenneally, K.F.",12190,"collector:""Kenneally, K.F.""",1878,2008,130
63,"Weber, J.Z.","collector.Weber, J.Z.",12133,"collector:""Weber, J.Z.""",1874,2009,135
64,"Royce, R.D.","collector.Royce, R.D.",12035,"collector:""Royce, R.D.""",1860,2000,140
65,"Donner, N.N.","collector.Donner, N.N.",12031,"collector:""Donner, N.N.""",1885,1997,112
66,"Brennan, K.","collector.Brennan, K.",11842,"collector:""Brennan, K.""",1967,2020,53
67,"Pullen, R.","collector.Pullen, R.",11709,"collector:""Pullen, R.""",1933,1999,66
68,"Moore, C.W.E.","collector.Moore, C.W.E.",11696,"collector:""Moore, C.W.E.""",1935,1998,63
69,"Whibley, D.J.E.","collector.Whibley, D.J.E.",11564,"collector:""Whibley, D.J.E.""",1907,1998,91
70,"Webb, L.J.","collector.Webb, L.J.",11153,"collector:""Webb, L.J.""",1931,1994,63
71,"Jobson, P.C.","collector.Jobson, P.C.",11106,"collector:""Jobson, P.C.""",1969,2017,48
72,"Walsh, N.G.","collector.Walsh, N.G.",11057,"collector:""Walsh, N.G.""",1894,2020,126
73,"Maslin, B.R.","collector.Maslin, B.R.",10950,"collector:""Maslin, B.R.""",1910,2013,103
74,"Mitchell, A.A.","collector.Mitchell, A.A.",10906,"collector:""Mitchell, A.A.""",1905,2017,112
75,"Newbey, K.R.","collector.Newbey, K.R.",10860,"collector:""Newbey, K.R.""",1931,1995,64
76,"Burbidge, N.T.","collector.Burbidge, N.T.",10712,"collector:""Burbidge, N.T.""",1891,1995,104
77,"Alcock, C.R.","collector.Alcock, C.R.",10542,"collector:""Alcock, C.R.""",1922,2011,89
78,"Dunlop, C.","collector.Dunlop, C.",10539,"collector:""Dunlop, C.""",1908,2003,95
79,"Briggs, B.G.","collector.Briggs, B.G.",10428,"collector:""Briggs, B.G.""",1939,2019,80
80,"Orchard, A.E.","collector.Orchard, A.E.",10356,"collector:""Orchard, A.E.""",1938,2017,79
81,"Albrecht, D.E.","collector.Albrecht, D.E.",10266,"collector:""Albrecht, D.E.""",1900,2019,119
82,"Chinnock, R.J.","collector.Chinnock, R.J.",10140,"collector:""Chinnock, R.J.""",1957,2018,61
83,"Everist, S.L.","collector.Everist, S.L.",10126,"collector:""Everist, S.L.""",1930,1984,54
84,"McBarron, E.J.","collector.McBarron, E.J.",10081,"collector:""McBarron, E.J.""",1903,2000,97
85,"Perry, R.A.","collector.Perry, R.A.",9831,"collector:""Perry, R.A.""",1843,1984,141
86,"Cribb, A.B.","collector.Cribb, A.B.",9657,"collector:""Cribb, A.B.""",1926,2014,88
87,"Corrick, M.G.","collector.Corrick, M.G.",9562,"collector:""Corrick, M.G.""",1935,2007,72
88,"Russell-Smith, J.","collector.Russell-Smith, J.",9443,"collector:""Russell-Smith, J.""",1979,2017,38
89,"Ewers, W.H.","collector.Ewers, W.H.",9252,"collector:""Ewers, W.H.""",1932,2007,75
90,"Chippendale, G.M.","collector.Chippendale, G.M.",9137,"collector:""Chippendale, G.M.""",1853,1994,141
91,"Wannan, B.S.","collector.Wannan, B.S.",9064,"collector:""Wannan, B.S.""",1975,2018,43
92,"Muir, T.B.","collector.Muir, T.B.",9057,"collector:""Muir, T.B.""",1879,1986,107
93,"Smith, L.S.","collector.Smith, L.S.",9008,"collector:""Smith, L.S.""",1854,1998,144
94,"Jacobs, S.W.L.","collector.Jacobs, S.W.L.",8766,"collector:""Jacobs, S.W.L.""",1882,2009,127
95,"Ford, A.","collector.Ford, A.",8746,"collector:""Ford, A.""",1989,2018,29
96,"Irvine, A.K.","collector.Irvine, A.K.",8698,"collector:""Irvine, A.K.""",1971,2000,29
97,"Curnow, J.A.","collector.Curnow, J.A.",8514,"collector:""Curnow, J.A.""",1968,2019,51
98,"Croxford, E.J.","collector.Croxford, E.J.",8456,"collector:""Croxford, E.J.""",1874,2001,127
99,"Powell, J.M.","collector.Powell, J.M.",8261,"collector:""Powell, J.M.""",1953,1997,44
100,"Halford, D.","collector.Halford, D.",8079,"collector:""Halford, D.""",1976,2016,40
101,"Helms, R.","collector.Helms, R.",8046,"collector:""Helms, R.""",1841,1999,158
102,"Lothian, T.R.N.","collector.Lothian, T.R.N.",8032,"collector:""Lothian, T.R.N.""",1904,1997,93
103,"Specht, R.L.","collector.Specht, R.L.",7800,"collector:""Specht, R.L.""",1939,1989,50
104,"Cumming, R.J.","collector.Cumming, R.J.",7762,"collector:""Cumming, R.J.""",1930,2013,83
105,"Byrne, G.","collector.Byrne, G.",7668,"collector:""Byrne, G.""",1965,2018,53
106,"Jackson, E.N.S.","collector.Jackson, E.N.S.",7432,"collector:""Jackson, E.N.S.""",1930,1992,62
107,"Ashby, A.M.","collector.Ashby, A.M.",7312,"collector:""Ashby, A.M.""",1920,1984,64
108,"Hubbard, C.E.","collector.Hubbard, C.E.",7289,"collector:""Hubbard, C.E.""",1920,1981,61
109,"Curtis, W.M.","collector.Curtis, W.M.",7274,"collector:""Curtis, W.M.""",1862,2005,143
110,"Keighery, G.J. | Gibson, N.","collector.Keighery, G.J. | Gibson, N.",7061,"collector:""Keighery, G.J. | Gibson, N.""",1990,2004,14
111,"Gray, M.","collector.Gray, M.",6954,"collector:""Gray, M.""",1935,2010,75
112,"Fensham, R.J.","collector.Fensham, R.J.",6907,"collector:""Fensham, R.J.""",1885,2019,134
113,"Wightman, G.","collector.Wightman, G.",6876,"collector:""Wightman, G.""",1946,2012,66
114,"Morrison, A.","collector.Morrison, A.",6845,"collector:""Morrison, A.""",1829,2010,181
115,"Beard, J.S.","collector.Beard, J.S.",6815,"collector:""Beard, J.S.""",1862,1998,136
116,"Booth, R.","collector.Booth, R.",6792,"collector:""Booth, R.""",1963,2017,54
117,"Brass, L.J.","collector.Brass, L.J.",6774,"collector:""Brass, L.J.""",1915,1998,83
118,"Rodd, A.N.","collector.Rodd, A.N.",6773,"collector:""Rodd, A.N.""",1876,2019,143
119,"Shepherd, S.A.","collector.Shepherd, S.A.",6764,"collector:""Shepherd, S.A.""",1940,2004,64
120,"Rodway, F.A.","collector.Rodway, F.A.",6761,"collector:""Rodway, F.A.""",1883,2001,118
121,"Lepschi, B.J.","collector.Lepschi, B.J.",6746,"collector:""Lepschi, B.J.""",1955,2018,63
122,"Fell, D.G.","collector.Fell, D.G.",6653,"collector:""Fell, D.G.""",1983,2018,35
123,"Waterhouse, B.M.","collector.Waterhouse, B.M.",6636,"collector:""Waterhouse, B.M.""",1980,2017,37
124,"Henshall, T.","collector.Henshall, T.",6594,"collector:""Henshall, T.""",1922,1989,67
125,"Rodway, L.","collector.Rodway, L.",6555,"collector:""Rodway, L.""",1864,2012,148
126,"Aplin, T.E.H.","collector.Aplin, T.E.H.",6538,"collector:""Aplin, T.E.H.""",1951,1998,47
127,"Kraehenbuehl, D.N.","collector.Kraehenbuehl, D.N.",6508,"collector:""Kraehenbuehl, D.N.""",1866,1999,133
128,"Barker, W.R.","collector.Barker, W.R.",6461,"collector:""Barker, W.R.""",1901,2018,117
129,"Byrnes, N.","collector.Byrnes, N.",6432,"collector:""Byrnes, N.""",1889,1997,108
130,"Murfet, D.E.","collector.Murfet, D.E.",6411,"collector:""Murfet, D.E.""",1966,2019,53
131,"Trudgen, M.E.","collector.Trudgen, M.E.",6409,"collector:""Trudgen, M.E.""",1971,2011,40
132,"Conn, B.J.","collector.Conn, B.J.",6370,"collector:""Conn, B.J.""",1961,2017,56
133,"Hill, K.D.","collector.Hill, K.D.",6347,"collector:""Hill, K.D.""",1964,2003,39
134,"Cunningham, G.M.","collector.Cunningham, G.M.",6298,"collector:""Cunningham, G.M.""",1909,2018,109
135,"Copeland, L.M.","collector.Copeland, L.M.",6287,"collector:""Copeland, L.M.""",1979,2018,39
136,leg. ign.,collector.leg. ign.,6278,"collector:""leg. ign.""",1809,2014,205
137,"Melville, R.","collector.Melville, R.",6265,"collector:""Melville, R.""",1853,2007,154
138,"Short, P.S.","collector.Short, P.S.",6255,"collector:""Short, P.S.""",1932,2011,79
139,"Pedley, L.","collector.Pedley, L.",6041,"collector:""Pedley, L.""",1862,2014,152
140,"Black, R.A.","collector.Black, R.A.",6032,"collector:""Black, R.A.""",1900,1996,96
141,"Gittins, C.H.","collector.Gittins, C.H.",5952,"collector:""Gittins, C.H.""",1945,1987,42
142,"Lang, P.J.","collector.Lang, P.J.",5949,"collector:""Lang, P.J.""",1967,2018,51
143,"Burgess, C.","collector.Burgess, C.",5828,"collector:""Burgess, C.""",1889,2009,120
144,"Clements, M.A.","collector.Clements, M.A.",5779,"collector:""Clements, M.A.""",1886,2019,133
145,Unknown,collector.Unknown,5765,"collector:""Unknown""",1801,2010,209
146,"Adams, L.G.","collector.Adams, L.G.",5745,"collector:""Adams, L.G.""",1948,2007,59
147,"Rupp, H.M.R.","collector.Rupp, H.M.R.",5666,"collector:""Rupp, H.M.R.""",1873,1987,114
148,"Aston, H.I.","collector.Aston, H.I.",5662,"collector:""Aston, H.I.""",1950,2000,50
149,"Slee, A.V.","collector.Slee, A.V.",5587,"collector:""Slee, A.V.""",1973,2020,47
150,"Copley, B.","collector.Copley, B.",5585,"collector:""Copley, B.""",1924,2000,76
151,"Williams, L.D.","collector.Williams, L.D.",5583,"collector:""Williams, L.D.""",1941,1997,56
152,"Dunlop, C.R.","collector.Dunlop, C.R.",5572,"collector:""Dunlop, C.R.""",1962,1999,37
153,"Beauglehole, A.","collector.Beauglehole, A.",5566,"collector:""Beauglehole, A.""",1940,1996,56
154,"Hopper, S.D.","collector.Hopper, S.D.",5523,"collector:""Hopper, S.D.""",1955,2019,64
155,"Simmons, J.G. | Simmons, M.H.","collector.Simmons, J.G. | Simmons, M.H.",5498,"collector:""Simmons, J.G. | Simmons, M.H.""",1944,2005,61
156,"Neldner, V.J.","collector.Neldner, V.J.",5482,"collector:""Neldner, V.J.""",1905,2018,113
157,"Price, I.R.","collector.Price, I.R.",5474,"collector:""Price, I.R.""",1684,1995,311
158,"Speck, N.H.","collector.Speck, N.H.",5469,"collector:""Speck, N.H.""",1917,1994,77
159,"Verdon, D.","collector.Verdon, D.",5444,"collector:""Verdon, D.""",1960,1994,34
160,"Gauba, E.","collector.Gauba, E.",5417,"collector:""Gauba, E.""",1900,1983,83
161,"Johnson, R.W.","collector.Johnson, R.W.",5401,"collector:""Johnson, R.W.""",1930,2010,80
162,"Forbes, S.J.","collector.Forbes, S.J.",5374,"collector:""Forbes, S.J.""",1937,2013,76
163,"Williamson, H.B.","collector.Williamson, H.B.",5362,"collector:""Williamson, H.B.""",1828,1992,164
164,"Foreman, D.B.","collector.Foreman, D.B.",5338,"collector:""Foreman, D.B.""",1924,2003,79
165,"Collier, P.A.","collector.Collier, P.A.",5265,"collector:""Collier, P.A.""",1958,2011,53
166,"Flecker, H.","collector.Flecker, H.",5201,"collector:""Flecker, H.""",1847,1980,133
167,"Dockrill, A.W.","collector.Dockrill, A.W.",5143,"collector:""Dockrill, A.W.""",1935,1983,48
168,"Briggs, J.D.","collector.Briggs, J.D.",5133,"collector:""Briggs, J.D.""",1897,2001,104
169,"Cowie, I.D.","collector.Cowie, I.D.",5102,"collector:""Cowie, I.D.""",1981,2018,37
170,"Tindale, M.D.","collector.Tindale, M.D.",5076,"collector:""Tindale, M.D.""",1923,2010,87
171,"Chesterfield, E.A.","collector.Chesterfield, E.A.",5028,"collector:""Chesterfield, E.A.""",1970,2002,32
172,"Lepp, H.","collector.Lepp, H.",5023,"collector:""Lepp, H.""",1977,2016,39
173,"Huisman, J.M.","collector.Huisman, J.M.",5008,"collector:""Huisman, J.M.""",1981,2019,38
174,"Sharpe, P.R.","collector.Sharpe, P.R.",5007,"collector:""Sharpe, P.R.""",1951,2007,56
175,"Blakely, W.F.","collector.Blakely, W.F.",4953,"collector:""Blakely, W.F.""",1887,1999,112
176,"Rogers, R.W.","collector.Rogers, R.W.",4945,"collector:""Rogers, R.W.""",1959,2016,57
177,Anonymous,collector.Anonymous,4893,"collector:""Anonymous""",1792,2018,226
178,"Egan, J.","collector.Egan, J.",4845,"collector:""Egan, J.""",1992,2006,14
179,"Lyne, A.M.","collector.Lyne, A.M.",4835,"collector:""Lyne, A.M.""",1955,2007,52
180,"Smith, R.V.","collector.Smith, R.V.",4729,"collector:""Smith, R.V.""",1941,2001,60
181,"Annels, A.R.","collector.Annels, A.R.",4706,"collector:""Annels, A.R.""",1897,1998,101
182,"Schodde, R.","collector.Schodde, R.",4693,"collector:""Schodde, R.""",1930,1998,68
183,"Hislop, M.","collector.Hislop, M.",4688,"collector:""Hislop, M.""",1993,2019,26
184,"Leach, G.","collector.Leach, G.",4657,"collector:""Leach, G.""",1954,2018,64
185,"Dallachy, J.","collector.Dallachy, J.",4638,"collector:""Dallachy, J.""",1848,1892,44
186,"Cambage, R.H.","collector.Cambage, R.H.",4633,"collector:""Cambage, R.H.""",1883,2011,128
187,"Ingram, C.K.","collector.Ingram, C.K.",4585,"collector:""Ingram, C.K.""",1933,2015,82
188,"Mitchell, A.","collector.Mitchell, A.",4569,"collector:""Mitchell, A.""",1895,2013,118
189,"Koch, M.","collector.Koch, M.",4493,"collector:""Koch, M.""",1819,1999,180
190,"Entwisle, T.J.","collector.Entwisle, T.J.",4483,"collector:""Entwisle, T.J.""",1980,2015,35
191,"Carr, G.W.","collector.Carr, G.W.",4471,"collector:""Carr, G.W.""",1924,2015,91
192,"Green, J.W.","collector.Green, J.W.",4454,"collector:""Green, J.W.""",1940,2012,72
193,"Thiele, K.R.","collector.Thiele, K.R.",4448,"collector:""Thiele, K.R.""",1973,2019,46
194,"Parris, M.","collector.Parris, M.",4404,"collector:""Parris, M.""",1970,1995,25
195,"Smith, B.H.","collector.Smith, B.H.",4389,"collector:""Smith, B.H.""",1898,2005,107
196,"Jago, R.L.","collector.Jago, R.L.",4371,"collector:""Jago, R.L.""",1968,2018,50
197,"Nicolle, D.","collector.Nicolle, D.",4351,"collector:""Nicolle, D.""",1990,2017,27
198,"Hind, P.D.","collector.Hind, P.D.",4342,"collector:""Hind, P.D.""",1966,2008,42
199,"Demarz, H.","collector.Demarz, H.",4299,"collector:""Demarz, H.""",1947,1994,47
200,"Baeuerlen, W.","collector.Baeuerlen, W.",4287,"collector:""Baeuerlen, W.""",1874,1990,116
201,"Wrigley, J.W.","collector.Wrigley, J.W.",4284,"collector:""Wrigley, J.W.""",1960,1996,36
202,"Sinkora, D.","collector.Sinkora, D.",4274,"collector:""Sinkora, D.""",1969,1993,24
203,"Cheel, E.","collector.Cheel, E.",4248,"collector:""Cheel, E.""",1840,2003,163
204,"Millar, A.J.K.","collector.Millar, A.J.K.",4201,"collector:""Millar, A.J.K.""",1979,2005,26
205,"Hunter, J.T.","collector.Hunter, J.T.",4185,"collector:""Hunter, J.T.""",1984,2012,28
206,"Baker, J.","collector.Baker, J.",4164,"collector:""Baker, J.""",1895,1997,102
207,"Michell, C.","collector.Michell, C.",4150,"collector:""Michell, C.""",1899,2002,103
208,"Jeanes, J.A.","collector.Jeanes, J.A.",4143,"collector:""Jeanes, J.A.""",1983,2018,35
209,"Thompson, J.","collector.Thompson, J.",4132,"collector:""Thompson, J.""",1898,2013,115
210,"Hoogland, R.D.","collector.Hoogland, R.D.",4108,"collector:""Hoogland, R.D.""",1951,1986,35
211,"Hunt, D.","collector.Hunt, D.",4107,"collector:""Hunt, D.""",1914,1997,83
212,"Fox, I.D.","collector.Fox, I.D.",4066,"collector:""Fox, I.D.""",1973,2014,41
213,"Harris, S.","collector.Harris, S.",4054,"collector:""Harris, S.""",1976,2018,42
214,"Moriarty, V.K.","collector.Moriarty, V.K.",4020,"collector:""Moriarty, V.K.""",1874,1986,112
215,"Thomson, B.","collector.Thomson, B.",4003,"collector:""Thomson, B.""",1951,1991,40
216,"Bäuerlen, W.","collector.Bäuerlen, W.",3987,"collector:""Bäuerlen, W.""",1880,1992,112
217,"Jessup, L.W.","collector.Jessup, L.W.",3978,"collector:""Jessup, L.W.""",1951,2017,66
218,"St John, P.R.H.","collector.St John, P.R.H.",3964,"collector:""St John, P.R.H.""",1881,2006,125
219,"Wakefield, N.A.","collector.Wakefield, N.A.",3942,"collector:""Wakefield, N.A.""",1918,1989,71
220,"Story, R.","collector.Story, R.",3940,"collector:""Story, R.""",1900,1996,96
221,"Thomas, M.B.","collector.Thomas, M.B.",3903,"collector:""Thomas, M.B.""",1965,2018,53
222,"Blaxell, D.F.","collector.Blaxell, D.F.",3890,"collector:""Blaxell, D.F.""",1954,2002,48
223,"Olde, P.M.","collector.Olde, P.M.",3887,"collector:""Olde, P.M.""",1904,2016,112
224,"Bruhl, J.J.","collector.Bruhl, J.J.",3883,"collector:""Bruhl, J.J.""",1975,2018,43
225,"Morris, D.I.","collector.Morris, D.I.",3865,"collector:""Morris, D.I.""",1961,2004,43
226,"Salasoo, H.","collector.Salasoo, H.",3865,"collector:""Salasoo, H.""",1917,1986,69
227,"Henderson, R.J.","collector.Henderson, R.J.",3861,"collector:""Henderson, R.J.""",1959,1999,40
228,"Tepper, J.G.O.","collector.Tepper, J.G.O.",3861,"collector:""Tepper, J.G.O.""",1829,1996,167
229,"Seppelt, R.D.","collector.Seppelt, R.D.",3820,"collector:""Seppelt, R.D.""",1966,2018,52
230,"Jensen, R.","collector.Jensen, R.",3805,"collector:""Jensen, R.""",1992,2019,27
231,"Pickard, J.","collector.Pickard, J.",3791,"collector:""Pickard, J.""",1961,1998,37
232,"Brown, E.A.","collector.Brown, E.A.",3788,"collector:""Brown, E.A.""",1974,2012,38
233,"Edinger, D.J.","collector.Edinger, D.J.",3782,"collector:""Edinger, D.J.""",1983,2009,26
234,"Edyvane, K.","collector.Edyvane, K.",3771,"collector:""Edyvane, K.""",1959,1995,36
235,"White, G.J.","collector.White, G.J.",3747,"collector:""White, G.J.""",1958,1995,37
236,"Archer, B.","collector.Archer, B.",3711,"collector:""Archer, B.""",1979,2006,27
237,"van Leeuwen, S.","collector.van Leeuwen, S.",3704,"collector:""van Leeuwen, S.""",1985,2014,29
238,"Brown, R.","collector.Brown, R.",3695,"collector:""Brown, R.""",1801,2008,207
239,"Kuchel, R.H.","collector.Kuchel, R.H.",3680,"collector:""Kuchel, R.H.""",1906,1981,75
240,"Must, J.","collector.Must, J.",3635,"collector:""Must, J.""",1957,2005,48
241,"Cooper, H.M.","collector.Cooper, H.M.",3630,"collector:""Cooper, H.M.""",1920,1988,68
242,"Clarke, I.C.","collector.Clarke, I.C.",3606,"collector:""Clarke, I.C.""",1898,2019,121
243,"Nelson, D.","collector.Nelson, D.",3594,"collector:""Nelson, D.""",1776,2010,234
244,"Stocker, G.C.","collector.Stocker, G.C.",3569,"collector:""Stocker, G.C.""",1959,1988,29
245,"Coveny, R.","collector.Coveny, R.",3560,"collector:""Coveny, R.""",1899,2012,113
246,"West, J.G.","collector.West, J.G.",3545,"collector:""West, J.G.""",1917,2011,94
247,"Lang, P.J. | Canty, P.D.","collector.Lang, P.J. | Canty, P.D.",3536,"collector:""Lang, P.J. | Canty, P.D.""",1994,2005,11
248,"Maconochie, J.R.","collector.Maconochie, J.R.",3448,"collector:""Maconochie, J.R.""",1919,1983,64
249,"Wheeler, J.R.","collector.Wheeler, J.R.",3432,"collector:""Wheeler, J.R.""",1958,2002,44
250,"Norris, D.H.","collector.Norris, D.H.",3417,"collector:""Norris, D.H.""",1973,1987,14
251,"Johnstone, R.L.","collector.Johnstone, R.L.",3407,"collector:""Johnstone, R.L.""",1980,2018,38
252,"Davies, F.E.","collector.Davies, F.E.",3390,"collector:""Davies, F.E.""",1938,2000,62
253,"Jones, W.T.","collector.Jones, W.T.",3382,"collector:""Jones, W.T.""",1866,1969,103
254,"Murfet, D.E. | Taplin, R.L.","collector.Murfet, D.E. | Taplin, R.L.",3363,"collector:""Murfet, D.E. | Taplin, R.L.""",1990,2010,20
255,"Nelson, D.J.","collector.Nelson, D.J.",3324,"collector:""Nelson, D.J.""",1958,1996,38
256,"Walter, C.","collector.Walter, C.",3301,"collector:""Walter, C.""",1835,1999,164
257,"Blackall, W.E.","collector.Blackall, W.E.",3278,"collector:""Blackall, W.E.""",1925,2012,87
258,"Gray, A.M.","collector.Gray, A.M.",3243,"collector:""Gray, A.M.""",1936,2017,81
259,"Haegi, L.","collector.Haegi, L.",3236,"collector:""Haegi, L.""",1948,1999,51
260,"Cooper, W. | Cooper, W.","collector.Cooper, W. | Cooper, W.",3230,"collector:""Cooper, W. | Cooper, W.""",1989,2006,17
261,"Ross, J.H.","collector.Ross, J.H.",3221,"collector:""Ross, J.H.""",1896,2005,109
262,"Maconochie, J.","collector.Maconochie, J.",3218,"collector:""Maconochie, J.""",1948,1987,39
263,"Jackes, B.R.","collector.Jackes, B.R.",3200,"collector:""Jackes, B.R.""",1955,2019,64
264,"Martensz, P.","collector.Martensz, P.",3142,"collector:""Martensz, P.""",1964,1997,33
265,"Lucas, A.H.S.","collector.Lucas, A.H.S.",3130,"collector:""Lucas, A.H.S.""",1801,1986,185
266,"Weston, P.H.","collector.Weston, P.H.",3116,"collector:""Weston, P.H.""",1974,2015,41
267,"Cann, H.J.","collector.Cann, H.J.",3108,"collector:""Cann, H.J.""",1900,1974,74
268,"O'Sullivan, W.","collector.O'Sullivan, W.",3105,"collector:""O'Sullivan, W.""",1988,2012,24
269,"Betche, E.","collector.Betche, E.",3098,"collector:""Betche, E.""",1850,1986,136
270,"Jobson, R.W.","collector.Jobson, R.W.",3089,"collector:""Jobson, R.W.""",1983,2018,35
271,"Skinner, S.","collector.Skinner, S.",3076,"collector:""Skinner, S.""",1967,2020,53
272,"Lewis, D.","collector.Lewis, D.",3075,"collector:""Lewis, D.""",1922,2019,97
273,"Risler, J.","collector.Risler, J.",3074,"collector:""Risler, J.""",1995,2011,16
274,"Weymouth, W.A.","collector.Weymouth, W.A.",3073,"collector:""Weymouth, W.A.""",1811,1990,179
275,"Camfield, J.H.","collector.Camfield, J.H.",3067,"collector:""Camfield, J.H.""",1871,1997,126
276,"Brodie, C.J.","collector.Brodie, C.J.",3045,"collector:""Brodie, C.J.""",2009,2018,9
277,"Gibson, N.","collector.Gibson, N.",3045,"collector:""Gibson, N.""",1908,2018,110
278,"Forsyth, W.","collector.Forsyth, W.",3043,"collector:""Forsyth, W.""",1865,1999,134
279,"Hall, N.","collector.Hall, N.",3022,"collector:""Hall, N.""",1883,1997,114
280,"Reader, F.M.","collector.Reader, F.M.",3022,"collector:""Reader, F.M.""",1854,1996,142
281,"Conrick, P.E.","collector.Conrick, P.E.",3020,"collector:""Conrick, P.E.""",1969,2000,31
282,"Renner, M.A.M.","collector.Renner, M.A.M.",3009,"collector:""Renner, M.A.M.""",2002,2019,17
283,"Williams, Lindley D.","collector.Williams, Lindley D.",2997,"collector:""Williams, Lindley D.""",1945,1994,49
284,"Markey, A. | Dillon, S.","collector.Markey, A. | Dillon, S.",2992,"collector:""Markey, A. | Dillon, S.""",2005,2015,10
285,"Pollock, A.B.","collector.Pollock, A.B.",2986,"collector:""Pollock, A.B.""",1988,2017,29
286,"Bratt, G.C.","collector.Bratt, G.C.",2976,"collector:""Bratt, G.C.""",1960,1977,17
287,"Carroll, E.J.","collector.Carroll, E.J.",2973,"collector:""Carroll, E.J.""",1962,1996,34
288,"Gunn, R.C.","collector.Gunn, R.C.",2973,"collector:""Gunn, R.C.""",1808,1939,131
289,"Paijmans, K.","collector.Paijmans, K.",2973,"collector:""Paijmans, K.""",1967,1999,32
290,"Sankowsky, G.","collector.Sankowsky, G.",2966,"collector:""Sankowsky, G.""",1968,2013,45
291,"Griffin, E.A.","collector.Griffin, E.A.",2955,"collector:""Griffin, E.A.""",1965,1993,28
292,"Jarman, J.","collector.Jarman, J.",2954,"collector:""Jarman, J.""",1973,2020,47
293,"Duguid, A.","collector.Duguid, A.",2948,"collector:""Duguid, A.""",1992,2016,24
294,"McKee, H.S.","collector.McKee, H.S.",2911,"collector:""McKee, H.S.""",1945,1972,27
295,"Syme, K.","collector.Syme, K.",2898,"collector:""Syme, K.""",1984,2018,34
296,"Scott, F.J.","collector.Scott, F.J.",2886,"collector:""Scott, F.J.""",1976,2017,41
297,"Blaylock, B.J.","collector.Blaylock, B.J.",2882,"collector:""Blaylock, B.J.""",1906,2008,102
298,"Handasyde, T.","collector.Handasyde, T.",2831,"collector:""Handasyde, T.""",1989,2017,28
299,"Gates, G.M. | Ratkowsky, D.A.","collector.Gates, G.M. | Ratkowsky, D.A.",2827,"collector:""Gates, G.M. | Ratkowsky, D.A.""",1996,2018,22
300,"Ratkowsky, A.V.","collector.Ratkowsky, A.V.",2821,"collector:""Ratkowsky, A.V.""",1959,1999,40
301,"Grimshaw, P.","collector.Grimshaw, P.",2819,"collector:""Grimshaw, P.""",1974,2015,41
302,"Levring, T.","collector.Levring, T.",2818,"collector:""Levring, T.""",1918,1978,60
303,"Bastow, R.A.","collector.Bastow, R.A.",2817,"collector:""Bastow, R.A.""",1854,1950,96
304,"Robbins, F.","collector.Robbins, F.",2814,"collector:""Robbins, F.""",1925,1986,61
305,"Forde, N.","collector.Forde, N.",2813,"collector:""Forde, N.""",1898,1991,93
306,"Floyd, A.G.","collector.Floyd, A.G.",2810,"collector:""Floyd, A.G.""",1928,2009,81
307,"Overton, B.M.","collector.Overton, B.M.",2809,"collector:""Overton, B.M.""",1980,2014,34
308,"Wiecek, B.M.","collector.Wiecek, B.M.",2807,"collector:""Wiecek, B.M.""",1964,2018,54
309,"Henshall, T.S.","collector.Henshall, T.S.",2801,"collector:""Henshall, T.S.""",1890,1990,100
310,"Gibson, N. | Lyons, M.","collector.Gibson, N. | Lyons, M.",2800,"collector:""Gibson, N. | Lyons, M.""",1989,1999,10
311,"Perrin, F.","collector.Perrin, F.",2790,"collector:""Perrin, F.""",1838,1967,129
312,"Perry, R.","collector.Perry, R.",2782,"collector:""Perry, R.""",1942,1979,37
313,"Jobson, P.","collector.Jobson, P.",2773,"collector:""Jobson, P.""",1969,2019,50
314,"Evans, M.","collector.Evans, M.",2767,"collector:""Evans, M.""",1923,2012,89
315,"Duretto, M.F.","collector.Duretto, M.F.",2756,"collector:""Duretto, M.F.""",1991,2018,27
316,"Sanderson, K.","collector.Sanderson, K.",2747,"collector:""Sanderson, K.""",1961,1998,37
317,"Thompson, S.L.","collector.Thompson, S.L.",2737,"collector:""Thompson, S.L.""",1997,2017,20
318,"Somerville, J.","collector.Somerville, J.",2729,"collector:""Somerville, J.""",1885,1968,83
319,"Gilmour, P.","collector.Gilmour, P.",2727,"collector:""Gilmour, P.""",1958,2006,48
320,"Milthorpe, P.L.","collector.Milthorpe, P.L.",2726,"collector:""Milthorpe, P.L.""",1967,2004,37
321,"French, C.J.","collector.French, C.J.",2718,"collector:""French, C.J.""",1907,2018,111
322,"Vonow, H.P.","collector.Vonow, H.P.",2717,"collector:""Vonow, H.P.""",1933,2015,82
323,"Craven, L.","collector.Craven, L.",2702,"collector:""Craven, L.""",1960,2006,46
324,"Cave, L.H.","collector.Cave, L.H.",2700,"collector:""Cave, L.H.""",1989,2020,31
325,"Halford, D.A.","collector.Halford, D.A.",2682,"collector:""Halford, D.A.""",1984,2018,34
326,"Lloyd, N.","collector.Lloyd, N.",2680,"collector:""Lloyd, N.""",1907,1997,90
327,"Smith, N.M.","collector.Smith, N.M.",2675,"collector:""Smith, N.M.""",1980,2014,34
328,"Simon, B.K.","collector.Simon, B.K.",2669,"collector:""Simon, B.K.""",1946,2013,67
329,"Taylor, J.","collector.Taylor, J.",2667,"collector:""Taylor, J.""",1916,2009,93
330,"White, S.A.","collector.White, S.A.",2660,"collector:""White, S.A.""",1897,2013,116
331,"Beadle, N.C.W.","collector.Beadle, N.C.W.",2650,"collector:""Beadle, N.C.W.""",1932,1989,57
332,"Kemp, J.","collector.Kemp, J.",2648,"collector:""Kemp, J.""",1974,2019,45
333,"Rogers, R.","collector.Rogers, R.",2647,"collector:""Rogers, R.""",1910,2006,96
334,"Heyligers, P.C.","collector.Heyligers, P.C.",2630,"collector:""Heyligers, P.C.""",1963,2010,47
335,"McDonald, W.J.","collector.McDonald, W.J.",2621,"collector:""McDonald, W.J.""",1873,2015,142
336,"Carrick, J.","collector.Carrick, J.",2612,"collector:""Carrick, J.""",1952,1979,27
337,"Mills, K.","collector.Mills, K.",2603,"collector:""Mills, K.""",1939,2017,78
338,"Waterhouse, J.T.","collector.Waterhouse, J.T.",2598,"collector:""Waterhouse, J.T.""",1936,1991,55
339,"McGillivray, D.J.","collector.McGillivray, D.J.",2595,"collector:""McGillivray, D.J.""",1847,1987,140
340,"Markey, A.","collector.Markey, A.",2592,"collector:""Markey, A.""",1996,2012,16
341,"Robinson, A.C.","collector.Robinson, A.C.",2585,"collector:""Robinson, A.C.""",1929,2016,87
342,"Williams, K.A.","collector.Williams, K.A.",2582,"collector:""Williams, K.A.""",1959,1992,33
343,"Bailey, F.M.","collector.Bailey, F.M.",2551,"collector:""Bailey, F.M.""",1869,1997,128
344,"Wapstra, M.","collector.Wapstra, M.",2530,"collector:""Wapstra, M.""",1992,2019,27
345,"Morris, A.","collector.Morris, A.",2528,"collector:""Morris, A.""",1872,2016,144
346,"Bratt, G.C.|Cashin, J.A.","collector.Bratt, G.C.|Cashin, J.A.",2524,"collector:""Bratt, G.C.|Cashin, J.A.""",1960,1985,25
347,"Phillips, S.P.","collector.Phillips, S.P.",2513,"collector:""Phillips, S.P.""",1996,2018,22
348,"Westaway, J.","collector.Westaway, J.",2513,"collector:""Westaway, J.""",1986,2018,32
349,"Hill, K.","collector.Hill, K.",2496,"collector:""Hill, K.""",1953,2006,53
350,"Boomsma, C.D.","collector.Boomsma, C.D.",2491,"collector:""Boomsma, C.D.""",1907,1992,85
351,"Andrews, G.","collector.Andrews, G.",2490,"collector:""Andrews, G.""",1994,1994,0
352,"Makinson, R.O.","collector.Makinson, R.O.",2482,"collector:""Makinson, R.O.""",1981,2009,28
353,"Donaldson, S.","collector.Donaldson, S.",2481,"collector:""Donaldson, S.""",1983,2007,24
354,"Stevens, N.","collector.Stevens, N.",2464,"collector:""Stevens, N.""",1953,2000,47
355,"Jurjevich, P.A.","collector.Jurjevich, P.A.",2459,"collector:""Jurjevich, P.A.""",1997,1997,0
356,"McCutcheon, G.S.","collector.McCutcheon, G.S.",2455,"collector:""McCutcheon, G.S.""",1958,2008,50
357,"Fitzgerald, W.V.","collector.Fitzgerald, W.V.",2432,"collector:""Fitzgerald, W.V.""",1874,1978,104
358,"Clemens, M.S.","collector.Clemens, M.S.",2428,"collector:""Clemens, M.S.""",1916,1958,42
359,"Greuter, W.","collector.Greuter, W.",2423,"collector:""Greuter, W.""",1973,2001,28
360,S. van Leeuwen et al.,collector.S. van Leeuwen et al.,2406,"collector:""S. van Leeuwen et al.""",2004,2006,2
361,"Clarkson, J.","collector.Clarkson, J.",2400,"collector:""Clarkson, J.""",1972,2016,44
362,"Nicholls, W.H.","collector.Nicholls, W.H.",2400,"collector:""Nicholls, W.H.""",1921,1962,41
363,"Barnsley, B.","collector.Barnsley, B.",2399,"collector:""Barnsley, B.""",1964,1999,35
364,"Eddie, C.","collector.Eddie, C.",2395,"collector:""Eddie, C.""",1995,2017,22
365,"Newbey, K.","collector.Newbey, K.",2395,"collector:""Newbey, K.""",1961,1987,26
366,"Karunajeewa, N.G.","collector.Karunajeewa, N.G.",2382,"collector:""Karunajeewa, N.G.""",2002,2020,18
367,"Schofield, W.B.","collector.Schofield, W.B.",2374,"collector:""Schofield, W.B.""",1883,1996,113
368,"Symon, D.","collector.Symon, D.",2364,"collector:""Symon, D.""",1910,2009,99
369,"Weston, A.S.","collector.Weston, A.S.",2362,"collector:""Weston, A.S.""",1892,1999,107
370,"Black, J.M.","collector.Black, J.M.",2355,"collector:""Black, J.M.""",1819,2016,197
371,"Jackson, G.","collector.Jackson, G.",2285,"collector:""Jackson, G.""",1880,2008,128
372,"Allan, M.","collector.Allan, M.",2279,"collector:""Allan, M.""",1945,2013,68
373,"Bougher, N.L.","collector.Bougher, N.L.",2273,"collector:""Bougher, N.L.""",1982,2018,36
374,"Smith, N.","collector.Smith, N.",2273,"collector:""Smith, N.""",1952,2018,66
375,"Vickery, J.W.","collector.Vickery, J.W.",2272,"collector:""Vickery, J.W.""",1912,1978,66
376,"Schubert, A.","collector.Schubert, A.",2244,"collector:""Schubert, A.""",2003,2018,15
377,"Bennett, E.M.","collector.Bennett, E.M.",2234,"collector:""Bennett, E.M.""",1941,2012,71
378,"Wilson, P.","collector.Wilson, P.",2234,"collector:""Wilson, P.""",1950,2006,56
379,"Mulham, W.E.","collector.Mulham, W.E.",2184,"collector:""Mulham, W.E.""",1920,1993,73
380,"Gurgel, C.F.","collector.Gurgel, C.F.",2181,"collector:""Gurgel, C.F.""",2007,2013,6
381,"Heard, L.M.B. | Neagle, N.R.","collector.Heard, L.M.B. | Neagle, N.R.",2172,"collector:""Heard, L.M.B. | Neagle, N.R.""",1998,2007,9
382,"Wilson, Peter G.","collector.Wilson, Peter G.",2168,"collector:""Wilson, Peter G.""",1959,2019,60
383,"Southcott, R.V.","collector.Southcott, R.V.",2161,"collector:""Southcott, R.V.""",1937,1994,57
384,"Rozefelds, A.C.","collector.Rozefelds, A.C.",2159,"collector:""Rozefelds, A.C.""",1964,2010,46
385,"Wrigley, J.","collector.Wrigley, J.",2156,"collector:""Wrigley, J.""",1966,2003,37
386,"French, C.","collector.French, C.",2147,"collector:""French, C.""",1853,2005,152
387,"Lally, T.R.","collector.Lally, T.R.",2146,"collector:""Lally, T.R.""",1976,2016,40
388,"Hort, F.","collector.Hort, F.",2133,"collector:""Hort, F.""",1993,2018,25
389,"Persieh, W.A.","collector.Persieh, W.A.",2129,"collector:""Persieh, W.A.""",1877,1887,10
390,"Brockman, G.","collector.Brockman, G.",2122,"collector:""Brockman, G.""",1994,2017,23
391,"Hartley, T.G.","collector.Hartley, T.G.",2116,"collector:""Hartley, T.G.""",1930,2004,74
392,"Lepschi, B.J. | Lally, T.R.","collector.Lepschi, B.J. | Lally, T.R.",2111,"collector:""Lepschi, B.J. | Lally, T.R.""",1994,2001,7
393,"Strid, A.","collector.Strid, A.",2096,"collector:""Strid, A.""",1972,1993,21
394,"Hnatiuk, R.J.","collector.Hnatiuk, R.J.",2087,"collector:""Hnatiuk, R.J.""",1917,1989,72
395,"Simson, A.","collector.Simson, A.",2077,"collector:""Simson, A.""",1838,1978,140
396,"Brown, A.J.","collector.Brown, A.J.",2072,"collector:""Brown, A.J.""",1941,2017,76
397,"Blake, S.","collector.Blake, S.",2069,"collector:""Blake, S.""",1834,2010,176
398,"Clark, M.","collector.Clark, M.",2063,"collector:""Clark, M.""",1895,1990,95
399,"Stephens, K.M.","collector.Stephens, K.M.",2053,"collector:""Stephens, K.M.""",1995,2012,17
400,"Morton, A.","collector.Morton, A.",2050,"collector:""Morton, A.""",1886,2005,119
401,"Leichhardt, F.W.L.","collector.Leichhardt, F.W.L.",2031,"collector:""Leichhardt, F.W.L.""",1827,2002,175
402,"Roe, R.","collector.Roe, R.",2026,"collector:""Roe, R.""",1927,1997,70
403,"Archer, W.R.","collector.Archer, W.R.",2022,"collector:""Archer, W.R.""",1978,2013,35
404,"Jacobs, S.","collector.Jacobs, S.",2020,"collector:""Jacobs, S.""",1896,2008,112
405,"Allen, M.G.","collector.Allen, M.G.",2019,"collector:""Allen, M.G.""",1996,1997,1
406,"Ralston, K.","collector.Ralston, K.",2006,"collector:""Ralston, K.""",1990,2007,17
407,"Tracey, J.G.","collector.Tracey, J.G.",1992,"collector:""Tracey, J.G.""",1950,2000,50
408,"Tate, R.","collector.Tate, R.",1982,"collector:""Tate, R.""",1837,1997,160
409,"Barlow, B.A.","collector.Barlow, B.A.",1970,"collector:""Barlow, B.A.""",1956,2000,44
410,"Patrick, S.","collector.Patrick, S.",1967,"collector:""Patrick, S.""",1983,2019,36
411,"Guymer, G.P.","collector.Guymer, G.P.",1963,"collector:""Guymer, G.P.""",1926,2015,89
412,"Volck, H.E.","collector.Volck, H.E.",1960,"collector:""Volck, H.E.""",1929,1971,42
413,"Leitch, E.","collector.Leitch, E.",1959,"collector:""Leitch, E.""",2007,2018,11
414,"McKenna, S.G.","collector.McKenna, S.G.",1956,"collector:""McKenna, S.G.""",2008,2018,10
415,"Kenny, M.","collector.Kenny, M.",1955,"collector:""Kenny, M.""",1906,1983,77
416,"Hoyle, N.","collector.Hoyle, N.",1952,"collector:""Hoyle, N.""",1907,1995,88
417,"MacKee, H.S.","collector.MacKee, H.S.",1948,"collector:""MacKee, H.S.""",1864,1996,132
418,"Wissmann, H.J.","collector.Wissmann, H.J.",1948,"collector:""Wissmann, H.J.""",1867,2007,140
419,"Wilson, J.B.","collector.Wilson, J.B.",1945,"collector:""Wilson, J.B.""",1872,1989,117
420,"Grace, J.","collector.Grace, J.",1942,"collector:""Grace, J.""",1893,2003,110
421,"Carr, D.J. | Carr, S.G.M.","collector.Carr, D.J. | Carr, S.G.M.",1939,"collector:""Carr, D.J. | Carr, S.G.M.""",1879,1987,108
422,"Hamilton, A.A.","collector.Hamilton, A.A.",1923,"collector:""Hamilton, A.A.""",1896,1922,26
423,"Hemmings, F.A.","collector.Hemmings, F.A.",1921,"collector:""Hemmings, F.A.""",1990,2019,29
424,"Messina, A.","collector.Messina, A.",1920,"collector:""Messina, A.""",2005,2020,15
425,"Forrest, J.","collector.Forrest, J.",1916,"collector:""Forrest, J.""",1818,2015,197
426,"Wajon, J.E.","collector.Wajon, J.E.",1913,"collector:""Wajon, J.E.""",1998,2016,18
427,"Jarman, S.J.","collector.Jarman, S.J.",1910,"collector:""Jarman, S.J.""",1970,2015,45
428,"Forster, P.","collector.Forster, P.",1904,"collector:""Forster, P.""",1983,2017,34
429,"Keighery, G.J. | Alford, J.J.","collector.Keighery, G.J. | Alford, J.J.",1901,"collector:""Keighery, G.J. | Alford, J.J.""",1973,1997,24
430,"French, M.","collector.French, M.",1899,"collector:""French, M.""",1979,2018,39
431,"Franks, A.J.","collector.Franks, A.J.",1890,"collector:""Franks, A.J.""",1991,2019,28
432,"Dietrich, A.","collector.Dietrich, A.",1885,"collector:""Dietrich, A.""",1836,1965,129
433,ACRA,collector.ACRA,1884,"collector:""ACRA""",1952,2018,66
434,"Anderson, E.R.","collector.Anderson, E.R.",1870,"collector:""Anderson, E.R.""",1965,2016,51
435,"Hammersley, B.G.","collector.Hammersley, B.G.",1867,"collector:""Hammersley, B.G.""",1979,2003,24
436,"Paull, G.","collector.Paull, G.",1855,"collector:""Paull, G.""",1996,1997,1
437,"Lyons, M.N. | Lyons, S.D.","collector.Lyons, M.N. | Lyons, S.D.",1853,"collector:""Lyons, M.N. | Lyons, S.D.""",1997,2017,20
438,"Mathieson, M.T.","collector.Mathieson, M.T.",1847,"collector:""Mathieson, M.T.""",1999,2018,19
439,"Perry, G.","collector.Perry, G.",1847,"collector:""Perry, G.""",1969,1986,17
440,"Wirf, B.","collector.Wirf, B.",1845,"collector:""Wirf, B.""",2004,2019,15
441,"Lullfitz, F.","collector.Lullfitz, F.",1830,"collector:""Lullfitz, F.""",1955,2004,49
442,"Carter, B.J.","collector.Carter, B.J.",1818,"collector:""Carter, B.J.""",1987,2009,22
443,"Beesley, P.","collector.Beesley, P.",1815,"collector:""Beesley, P.""",1981,1996,15
444,"Boland, D.J.","collector.Boland, D.J.",1813,"collector:""Boland, D.J.""",1969,1997,28
445,"Sharpe, P.","collector.Sharpe, P.",1812,"collector:""Sharpe, P.""",1969,1993,24
446,"Pulley, J.","collector.Pulley, J.",1810,"collector:""Pulley, J.""",1956,1975,19
447,"Whaite, T.M.","collector.Whaite, T.M.",1810,"collector:""Whaite, T.M.""",1916,1985,69
448,"Klaphake, V.","collector.Klaphake, V.",1808,"collector:""Klaphake, V.""",1962,2014,52
449,"Carr, D.J.","collector.Carr, D.J.",1807,"collector:""Carr, D.J.""",1954,1996,42
450,"Orme, A.E.","collector.Orme, A.E.",1806,"collector:""Orme, A.E.""",1983,2019,36
451,"Brock, C.","collector.Brock, C.",1799,"collector:""Brock, C.""",1996,2018,22
452,"Simmonds, J.H.","collector.Simmonds, J.H.",1798,"collector:""Simmonds, J.H.""",1881,1998,117
453,"Crichton, G.A.","collector.Crichton, G.A.",1793,"collector:""Crichton, G.A.""",1945,1997,52
454,"Craig, G.F.","collector.Craig, G.F.",1787,"collector:""Craig, G.F.""",1984,2019,35
455,"Barritt, M.","collector.Barritt, M.",1779,"collector:""Barritt, M.""",1981,2004,23
456,"Eichler, H.","collector.Eichler, H.",1778,"collector:""Eichler, H.""",1956,2000,44
457,"Rankin, M.","collector.Rankin, M.",1775,"collector:""Rankin, M.""",1900,1999,99
458,"McIntyre, S.","collector.McIntyre, S.",1771,"collector:""McIntyre, S.""",1982,2012,30
459,"Kealley, M.J.","collector.Kealley, M.J.",1768,"collector:""Kealley, M.J.""",1997,1997,0
460,"Swinbourne, R.","collector.Swinbourne, R.",1752,"collector:""Swinbourne, R.""",1957,1987,30
461,"Martensz, P.N.","collector.Martensz, P.N.",1735,"collector:""Martensz, P.N.""",1953,1997,44
462,"Champion, I.G.","collector.Champion, I.G.",1727,"collector:""Champion, I.G.""",1974,2017,43
463,"Barrett, R.L.","collector.Barrett, R.L.",1726,"collector:""Barrett, R.L.""",1991,2017,26
464,"Alcock, C.Ray","collector.Alcock, C.Ray",1713,"collector:""Alcock, C.Ray""",1963,1993,30
465,"Hislop, M. | Griffiths, M.","collector.Hislop, M. | Griffiths, M.",1712,"collector:""Hislop, M. | Griffiths, M.""",2003,2008,5
466,"Cargill, D.C.","collector.Cargill, D.C.",1682,"collector:""Cargill, D.C.""",1980,2019,39
467,G.J. & B.J. Keighery,collector.G.J. & B.J. Keighery,1678,"collector:""G.J. & B.J. Keighery""",1972,2019,47
468,"Ballingall, M.E.","collector.Ballingall, M.E.",1676,"collector:""Ballingall, M.E.""",1935,1997,62
469,"Smith, T.J.","collector.Smith, T.J.",1676,"collector:""Smith, T.J.""",1954,1979,25
470,"Leeuwen, S. van","collector.Leeuwen, S. van",1675,"collector:""Leeuwen, S. van""",1985,2006,21
471,"Evans, O.D.","collector.Evans, O.D.",1672,"collector:""Evans, O.D.""",1911,1981,70
472,"Long, F.H.","collector.Long, F.H.",1671,"collector:""Long, F.H.""",1903,1981,78
473,"Sammy, N.","collector.Sammy, N.",1668,"collector:""Sammy, N.""",1967,2005,38
474,"Costion, C.","collector.Costion, C.",1667,"collector:""Costion, C.""",2008,2010,2
475,"Robinson, R.M.","collector.Robinson, R.M.",1667,"collector:""Robinson, R.M.""",1991,2014,23
476,"Gundry, A.","collector.Gundry, A.",1664,"collector:""Gundry, A.""",1997,1997,0
477,"Carr, G.W. | Beauglehole, A.C.","collector.Carr, G.W. | Beauglehole, A.C.",1663,"collector:""Carr, G.W. | Beauglehole, A.C.""",1964,1994,30
478,"Cunningham, A.","collector.Cunningham, A.",1663,"collector:""Cunningham, A.""",1791,1928,137
479,"Preiss, J.A.L.","collector.Preiss, J.A.L.",1663,"collector:""Preiss, J.A.L.""",1837,1887,50
480,"Fletcher, J.J.","collector.Fletcher, J.J.",1662,"collector:""Fletcher, J.J.""",1880,1992,112
481,"Hilton, F.M.","collector.Hilton, F.M.",1662,"collector:""Hilton, F.M.""",1905,1985,80
482,"Wollaston, E.","collector.Wollaston, E.",1660,"collector:""Wollaston, E.""",1952,1986,34
483,"Sinnott, N.H.","collector.Sinnott, N.H.",1658,"collector:""Sinnott, N.H.""",1944,2015,71
484,"Kalotas, A.","collector.Kalotas, A.",1648,"collector:""Kalotas, A.""",1900,1997,97
485,"Turpin, G.P.","collector.Turpin, G.P.",1637,"collector:""Turpin, G.P.""",1985,2018,33
486,"Silcock, J.L.","collector.Silcock, J.L.",1627,"collector:""Silcock, J.L.""",2004,2016,12
487,"Kodela, P.G.","collector.Kodela, P.G.",1626,"collector:""Kodela, P.G.""",1984,2017,33
488,"Baker, R.T.","collector.Baker, R.T.",1617,"collector:""Baker, R.T.""",1856,2009,153
489,"Munir, A.A.","collector.Munir, A.A.",1603,"collector:""Munir, A.A.""",1937,1988,51
490,"Wilson, I.B.","collector.Wilson, I.B.",1601,"collector:""Wilson, I.B.""",1886,2004,118
491,"Ollerenshaw, P.","collector.Ollerenshaw, P.",1600,"collector:""Ollerenshaw, P.""",1955,2018,63
492,"Wilson, F.R.M.","collector.Wilson, F.R.M.",1600,"collector:""Wilson, F.R.M.""",1827,1997,170
493,"McDonald, K.","collector.McDonald, K.",1596,"collector:""McDonald, K.""",1886,2018,132
494,"Puttock, C.F.","collector.Puttock, C.F.",1595,"collector:""Puttock, C.F.""",1953,1997,44
495,"McKean, J.","collector.McKean, J.",1588,"collector:""McKean, J.""",1903,2019,116
496,"Hnatiuk, R.","collector.Hnatiuk, R.",1576,"collector:""Hnatiuk, R.""",1928,2007,79
497,"Canty, P.","collector.Canty, P.",1568,"collector:""Canty, P.""",1978,1994,16
498,"Huisman, J.","collector.Huisman, J.",1553,"collector:""Huisman, J.""",1979,2015,36
499,"Hemsley, J.H.","collector.Hemsley, J.H.",1550,"collector:""Hemsley, J.H.""",1923,1993,70
500,"Jackson, W.D.","collector.Jackson, W.D.",1550,"collector:""Jackson, W.D.""",1943,1998,55
501,"Worboys, S.J.","collector.Worboys, S.J.",1549,"collector:""Worboys, S.J.""",1988,2020,32
502,"May, S.","collector.May, S.",1546,"collector:""May, S.""",1997,1997,0
503,"Hodgon, J.","collector.Hodgon, J.",1541,"collector:""Hodgon, J.""",1994,2005,11
504,"Crocker, R.L.","collector.Crocker, R.L.",1540,"collector:""Crocker, R.L.""",1839,1994,155
505,"Connors, J.R.","collector.Connors, J.R.",1538,"collector:""Connors, J.R.""",1994,2009,15
506,"Dodd, J.","collector.Dodd, J.",1537,"collector:""Dodd, J.""",1956,2018,62
507,"Saffrey, R.A.","collector.Saffrey, R.A.",1531,"collector:""Saffrey, R.A.""",1962,1980,18
508,"Stuart, C.","collector.Stuart, C.",1531,"collector:""Stuart, C.""",1838,1963,125
509,"Hill, R.","collector.Hill, R.",1530,"collector:""Hill, R.""",1925,2009,84
510,"Leiper, G.","collector.Leiper, G.",1526,"collector:""Leiper, G.""",1983,2018,35
511,"Stevens, G.N.","collector.Stevens, G.N.",1525,"collector:""Stevens, G.N.""",1974,1999,25
512,"Duncan, F.","collector.Duncan, F.",1521,"collector:""Duncan, F.""",1944,2007,63
513,"Hartley, W.","collector.Hartley, W.",1515,"collector:""Hartley, W.""",1923,1987,64
514,"Le Cussan, J.","collector.Le Cussan, J.",1514,"collector:""Le Cussan, J.""",1989,2005,16
515,"Cosh, J.","collector.Cosh, J.",1509,"collector:""Cosh, J.""",1970,2000,30
516,"Thorne, R.F.","collector.Thorne, R.F.",1501,"collector:""Thorne, R.F.""",1949,1981,32
517,"Harwood, R.","collector.Harwood, R.",1500,"collector:""Harwood, R.""",1994,2006,12
518,"Fox, J.M.","collector.Fox, J.M.",1496,"collector:""Fox, J.M.""",1979,1988,9
519,"Hill, G.F.","collector.Hill, G.F.",1490,"collector:""Hill, G.F.""",1895,1951,56
520,"Jago, B.","collector.Jago, B.",1488,"collector:""Jago, B.""",1975,2015,40
521,"Fensham, R.","collector.Fensham, R.",1485,"collector:""Fensham, R.""",1982,2019,37
522,"Parker, M.","collector.Parker, M.",1485,"collector:""Parker, M.""",1900,1984,84
523,"Alford, J.J.","collector.Alford, J.J.",1473,"collector:""Alford, J.J.""",1980,2001,21
524,"Sweedman, L.S.J.","collector.Sweedman, L.S.J.",1466,"collector:""Sweedman, L.S.J.""",1991,2017,26
525,"Tadgell, A.J.","collector.Tadgell, A.J.",1464,"collector:""Tadgell, A.J.""",1886,1966,80
526,"Webb, W.","collector.Webb, W.",1459,"collector:""Webb, W.""",1816,1896,80
527,"Lewis, S.H.","collector.Lewis, S.H.",1454,"collector:""Lewis, S.H.""",1971,2003,32
528,"Merrall, E.","collector.Merrall, E.",1452,"collector:""Merrall, E.""",1807,1899,92
529,"Macfarlane, T.D.","collector.Macfarlane, T.D.",1447,"collector:""Macfarlane, T.D.""",1973,2018,45
530,"Barker, R.M.","collector.Barker, R.M.",1446,"collector:""Barker, R.M.""",1855,2016,161
531,"O'Shanesy, P.A.","collector.O'Shanesy, P.A.",1442,"collector:""O'Shanesy, P.A.""",1863,1887,24
532,"Staples, I.B.","collector.Staples, I.B.",1433,"collector:""Staples, I.B.""",1952,1995,43
533,"Palmer, J.","collector.Palmer, J.",1431,"collector:""Palmer, J.""",1915,2013,98
534,"McHard, M.","collector.McHard, M.",1430,"collector:""McHard, M.""",1847,1895,48
535,"Durrington, L.","collector.Durrington, L.",1429,"collector:""Durrington, L.""",1969,1975,6
536,"Eldridge, D.J.","collector.Eldridge, D.J.",1427,"collector:""Eldridge, D.J.""",1980,2015,35
537,"Harada, K.","collector.Harada, K.",1427,"collector:""Harada, K.""",1909,1999,90
538,"Taws, N.M.","collector.Taws, N.M.",1426,"collector:""Taws, N.M.""",1993,2013,20
539,"McPherson, H.","collector.McPherson, H.",1420,"collector:""McPherson, H.""",2000,2015,15
540,"Chandler, G.T.","collector.Chandler, G.T.",1410,"collector:""Chandler, G.T.""",1993,2015,22
541,"Marchant, N.G.","collector.Marchant, N.G.",1409,"collector:""Marchant, N.G.""",1905,2008,103
542,"Hancock, M.","collector.Hancock, M.",1408,"collector:""Hancock, M.""",1988,2004,16
543,"Sayer, W.A.","collector.Sayer, W.A.",1408,"collector:""Sayer, W.A.""",1877,1898,21
544,"Alcock, C. Ray","collector.Alcock, C. Ray",1407,"collector:""Alcock, C. Ray""",1962,1995,33
545,"Goodall, D.W.","collector.Goodall, D.W.",1407,"collector:""Goodall, D.W.""",1950,1999,49
546,"Menkhorst, K.","collector.Menkhorst, K.",1407,"collector:""Menkhorst, K.""",1984,1997,13
547,"Piggin, J.","collector.Piggin, J.",1404,"collector:""Piggin, J.""",1971,2001,30
548,"Bennett, M.","collector.Bennett, M.",1403,"collector:""Bennett, M.""",1894,2018,124
549,"Godwin, M.","collector.Godwin, M.",1403,"collector:""Godwin, M.""",1975,2001,26
550,"Everett, J.","collector.Everett, J.",1400,"collector:""Everett, J.""",1980,2006,26
551,"Pedersen, S.","collector.Pedersen, S.",1400,"collector:""Pedersen, S.""",1993,2018,25
552,"Hunter, J.","collector.Hunter, J.",1396,"collector:""Hunter, J.""",1921,2006,85
553,"Cameron, E.","collector.Cameron, E.",1395,"collector:""Cameron, E.""",1965,1986,21
554,"Leach, G.J.","collector.Leach, G.J.",1395,"collector:""Leach, G.J.""",1901,2002,101
555,"Boyland, D.E.","collector.Boyland, D.E.",1392,"collector:""Boyland, D.E.""",1957,1979,22
556,"Johnson, D.C.","collector.Johnson, D.C.",1392,"collector:""Johnson, D.C.""",1995,2015,20
557,"Johnson, Stephen","collector.Johnson, Stephen",1392,"collector:""Johnson, Stephen""",1875,1895,20
558,"Winkworth, R.E.","collector.Winkworth, R.E.",1386,"collector:""Winkworth, R.E.""",1854,1970,116
559,"Henry, N.","collector.Henry, N.",1382,"collector:""Henry, N.""",1873,1978,105
560,"Stewart, G.","collector.Stewart, G.",1380,"collector:""Stewart, G.""",1945,2015,70
561,"James, T.A.","collector.James, T.A.",1367,"collector:""James, T.A.""",1961,2013,52
562,"Jessup, R.W.","collector.Jessup, R.W.",1367,"collector:""Jessup, R.W.""",1944,1995,51
563,"Lebel, T.","collector.Lebel, T.",1364,"collector:""Lebel, T.""",1986,2017,31
564,"Thompson, W.A. | Allen, J.","collector.Thompson, W.A. | Allen, J.",1363,"collector:""Thompson, W.A. | Allen, J.""",2009,2009,0
565,"Gates, G.M.|Ratkowsky, D.A.","collector.Gates, G.M.|Ratkowsky, D.A.",1360,"collector:""Gates, G.M.|Ratkowsky, D.A.""",1998,2018,20
566,"McAuliffe, J.","collector.McAuliffe, J.",1355,"collector:""McAuliffe, J.""",1910,2019,109
567,"O'Malley, C.","collector.O'Malley, C.",1355,"collector:""O'Malley, C.""",1914,2015,101
568,"Eardley, C.M.","collector.Eardley, C.M.",1354,"collector:""Eardley, C.M.""",1844,1987,143
569,"Kanis, A.","collector.Kanis, A.",1351,"collector:""Kanis, A.""",1873,1987,114
570,"Risley, T.S.","collector.Risley, T.S.",1346,"collector:""Risley, T.S.""",1971,1986,15
571,"Gates, G.M.","collector.Gates, G.M.",1343,"collector:""Gates, G.M.""",1997,2019,22
572,"Roberts, J.","collector.Roberts, J.",1331,"collector:""Roberts, J.""",1886,2019,133
573,"Dansie, S.J.","collector.Dansie, S.J.",1330,"collector:""Dansie, S.J.""",1953,2006,53
574,"Brodie, C.J. | Symon, D.E.","collector.Brodie, C.J. | Symon, D.E.",1322,"collector:""Brodie, C.J. | Symon, D.E.""",2009,2011,2
575,"Lumbsch, H.T.","collector.Lumbsch, H.T.",1322,"collector:""Lumbsch, H.T.""",1987,1996,9
576,"Taplin, R.L. | Murfet, D.E.","collector.Taplin, R.L. | Murfet, D.E.",1314,"collector:""Taplin, R.L. | Murfet, D.E.""",1983,2008,25
577,"Brown, M.J.","collector.Brown, M.J.",1312,"collector:""Brown, M.J.""",1973,1999,26
578,"Francis, W.D.","collector.Francis, W.D.",1312,"collector:""Francis, W.D.""",1910,1966,56
579,"Dixon, D.","collector.Dixon, D.",1308,"collector:""Dixon, D.""",1930,2008,78
580,"Michael, P.W.","collector.Michael, P.W.",1302,"collector:""Michael, P.W.""",1946,2019,73
581,"Bird, L.H.","collector.Bird, L.H.",1299,"collector:""Bird, L.H.""",1900,2007,107
582,"Noble, M.G.","collector.Noble, M.G.",1299,"collector:""Noble, M.G.""",1970,1987,17
583,"Johnston, J.","collector.Johnston, J.",1297,"collector:""Johnston, J.""",1893,2014,121
584,"Sharrad, M.C.R.","collector.Sharrad, M.C.R.",1295,"collector:""Sharrad, M.C.R.""",1956,1977,21
585,"Brushe, J.","collector.Brushe, J.",1292,"collector:""Brushe, J.""",1990,2008,18
586,"Henderson, D.L.W.","collector.Henderson, D.L.W.",1291,"collector:""Henderson, D.L.W.""",1939,1970,31
587,"Catcheside, P.S. | Catcheside, D.E.A.","collector.Catcheside, P.S. | Catcheside, D.E.A.",1287,"collector:""Catcheside, P.S. | Catcheside, D.E.A.""",1972,2009,37
588,"Michael, N.","collector.Michael, N.",1284,"collector:""Michael, N.""",1898,1985,87
589,"Galbraith, J.","collector.Galbraith, J.",1277,"collector:""Galbraith, J.""",1922,1992,70
590,"Canty, P.D.","collector.Canty, P.D.",1272,"collector:""Canty, P.D.""",1978,2006,28
591,"Osborn, T.G.B.","collector.Osborn, T.G.B.",1268,"collector:""Osborn, T.G.B.""",1907,1982,75
592,"May, V.","collector.May, V.",1267,"collector:""May, V.""",1909,1994,85
593,"Parsons, D.","collector.Parsons, D.",1267,"collector:""Parsons, D.""",1978,2012,34
594,"Winkworth, R.","collector.Winkworth, R.",1264,"collector:""Winkworth, R.""",1933,1981,48
595,"Mills, A.K.","collector.Mills, A.K.",1263,"collector:""Mills, A.K.""",1973,1999,26
596,"Cumming, R.","collector.Cumming, R.",1259,"collector:""Cumming, R.""",1975,2010,35
597,"Barrett, S.","collector.Barrett, S.",1258,"collector:""Barrett, S.""",1983,2017,34
598,"Browne, J.H.","collector.Browne, J.H.",1258,"collector:""Browne, J.H.""",1874,2017,143
599,"Sieber, F.W.","collector.Sieber, F.W.",1256,"collector:""Sieber, F.W.""",1789,1900,111
600,"Ingwersen, F.","collector.Ingwersen, F.",1255,"collector:""Ingwersen, F.""",1962,1996,34
601,"Whitehead, B.","collector.Whitehead, B.",1255,"collector:""Whitehead, B.""",1954,1996,42
602,"Beuzeville, W.A.W. de","collector.Beuzeville, W.A.W. de",1254,"collector:""Beuzeville, W.A.W. de""",1915,1981,66
603,"Wittwer, E.","collector.Wittwer, E.",1254,"collector:""Wittwer, E.""",1962,1985,23
604,"Baker, M.L.","collector.Baker, M.L.",1253,"collector:""Baker, M.L.""",2002,2019,17
605,"Sikkes, A.J.A.","collector.Sikkes, A.J.A.",1253,"collector:""Sikkes, A.J.A.""",1970,1974,4
606,"Nelson, E.C.","collector.Nelson, E.C.",1250,"collector:""Nelson, E.C.""",1905,1988,83
607,"Short, P.","collector.Short, P.",1250,"collector:""Short, P.""",1930,2012,82
608,"Armstrong, P.","collector.Armstrong, P.",1248,"collector:""Armstrong, P.""",1913,2019,106
609,"McDonald, T.J.","collector.McDonald, T.J.",1248,"collector:""McDonald, T.J.""",1960,1986,26
610,"Davies, S.J.J.","collector.Davies, S.J.J.",1245,"collector:""Davies, S.J.J.""",1957,1979,22
611,"Kirkman, H.","collector.Kirkman, H.",1244,"collector:""Kirkman, H.""",1970,2004,34
612,"Scarlett, N.H.","collector.Scarlett, N.H.",1241,"collector:""Scarlett, N.H.""",1944,2018,74
613,"Copley, P.","collector.Copley, P.",1240,"collector:""Copley, P.""",1966,2004,38
614,"Filson, R.","collector.Filson, R.",1239,"collector:""Filson, R.""",1956,1999,43
615,"Kabay, E.D.","collector.Kabay, E.D.",1238,"collector:""Kabay, E.D.""",1993,1995,2
616,"Toelken, H.R.","collector.Toelken, H.R.",1238,"collector:""Toelken, H.R.""",1979,1992,13
617,"Rogers, R.S.","collector.Rogers, R.S.",1237,"collector:""Rogers, R.S.""",1862,2007,145
618,"Archer, A.W.","collector.Archer, A.W.",1233,"collector:""Archer, A.W.""",1966,2011,45
619,"Cayzer, L.W.","collector.Cayzer, L.W.",1233,"collector:""Cayzer, L.W.""",1994,2013,19
620,"Collins, T.","collector.Collins, T.",1228,"collector:""Collins, T.""",2001,2018,17
621,"Cochrane, A.C.","collector.Cochrane, A.C.",1227,"collector:""Cochrane, A.C.""",1998,2000,2
622,"Ratkowsky, D.A.","collector.Ratkowsky, D.A.",1227,"collector:""Ratkowsky, D.A.""",1972,2015,43
623,"Stove, K.","collector.Stove, K.",1227,"collector:""Stove, K.""",1960,1993,33
624,"Sandiford, E.M.","collector.Sandiford, E.M.",1226,"collector:""Sandiford, E.M.""",1986,2016,30
625,"Cranfield, R.J. | Ward, B.G.","collector.Cranfield, R.J. | Ward, B.G.",1223,"collector:""Cranfield, R.J. | Ward, B.G.""",2001,2010,9
626,"Taseski, G.M.","collector.Taseski, G.M.",1214,"collector:""Taseski, G.M.""",2014,2019,5
627,"Fairall, A.R.","collector.Fairall, A.R.",1211,"collector:""Fairall, A.R.""",1957,1977,20
628,"Edinger, D.J. | Marsh, G.","collector.Edinger, D.J. | Marsh, G.",1204,"collector:""Edinger, D.J. | Marsh, G.""",1997,2004,7
629,"Allen, G.H.","collector.Allen, G.H.",1203,"collector:""Allen, G.H.""",1919,1973,54
630,"Taylor, R.","collector.Taylor, R.",1197,"collector:""Taylor, R.""",1965,2017,52
631,"Kerrigan, R.","collector.Kerrigan, R.",1196,"collector:""Kerrigan, R.""",1991,2017,26
632,"Lowrie, A.","collector.Lowrie, A.",1192,"collector:""Lowrie, A.""",1983,2014,31
633,"Benson, D.H.","collector.Benson, D.H.",1186,"collector:""Benson, D.H.""",1912,2007,95
634,"Leigh, J.H.","collector.Leigh, J.H.",1179,"collector:""Leigh, J.H.""",1956,1971,15
635,"Gilbert, L.A.J.","collector.Gilbert, L.A.J.",1178,"collector:""Gilbert, L.A.J.""",1942,1994,52
636,"Schmidt-Lebuhn, A.N.","collector.Schmidt-Lebuhn, A.N.",1173,"collector:""Schmidt-Lebuhn, A.N.""",2010,2018,8
637,"Zich, F.A.","collector.Zich, F.A.",1173,"collector:""Zich, F.A.""",1989,2019,30
638,"McVean, D.","collector.McVean, D.",1171,"collector:""McVean, D.""",1963,1984,21
639,"LeBreton, C.","collector.LeBreton, C.",1168,"collector:""LeBreton, C.""",1975,1991,16
640,"Althofer, G.W.","collector.Althofer, G.W.",1160,"collector:""Althofer, G.W.""",1935,1987,52
641,"Lay, B.","collector.Lay, B.",1156,"collector:""Lay, B.""",1920,2009,89
642,"Strong, B.","collector.Strong, B.",1155,"collector:""Strong, B.""",1976,1988,12
643,"Mackay, D.F.","collector.Mackay, D.F.",1154,"collector:""Mackay, D.F.""",1964,1994,30
644,"Klazenga, N.","collector.Klazenga, N.",1151,"collector:""Klazenga, N.""",1999,2018,19
645,"Smith, G.G.","collector.Smith, G.G.",1149,"collector:""Smith, G.G.""",1934,1996,62
646,"Coates, A.M.","collector.Coates, A.M.",1148,"collector:""Coates, A.M.""",1982,2016,34
647,Wildflower Society of WA,collector.Wildflower Society of WA,1147,"collector:""Wildflower Society of WA""",2003,2016,13
648,"Koch, Max","collector.Koch, Max",1145,"collector:""Koch, Max""",1889,1990,101
649,"Fagg, M.","collector.Fagg, M.",1143,"collector:""Fagg, M.""",1962,2006,44
650,"Butler, G.","collector.Butler, G.",1141,"collector:""Butler, G.""",1971,1994,23
651,"Wace, N.M.","collector.Wace, N.M.",1136,"collector:""Wace, N.M.""",1962,1986,24
652,"Halliday, T.A.","collector.Halliday, T.A.",1132,"collector:""Halliday, T.A.""",1971,1981,10
653,"Lewis, D.L.","collector.Lewis, D.L.",1131,"collector:""Lewis, D.L.""",2004,2017,13
654,"Benson, J.S.","collector.Benson, J.S.",1130,"collector:""Benson, J.S.""",1970,2009,39
655,"Whalen, A.J.","collector.Whalen, A.J.",1129,"collector:""Whalen, A.J.""",1993,2017,24
656,"Fox, I.","collector.Fox, I.",1128,"collector:""Fox, I.""",1967,2015,48
657,"Trappe, J.M.","collector.Trappe, J.M.",1128,"collector:""Trappe, J.M.""",1975,2010,35
658,"Davis, M.","collector.Davis, M.",1126,"collector:""Davis, M.""",1925,2010,85
659,"Pearson, D.J.","collector.Pearson, D.J.",1123,"collector:""Pearson, D.J.""",1980,2009,29
660,"Johnston, R.D.","collector.Johnston, R.D.",1119,"collector:""Johnston, R.D.""",1951,1977,26
661,"Thompson, S.","collector.Thompson, S.",1119,"collector:""Thompson, S.""",1903,2019,116
662,"Downing, A.J.","collector.Downing, A.J.",1117,"collector:""Downing, A.J.""",1909,2015,106
663,"Claridge, A.W.","collector.Claridge, A.W.",1115,"collector:""Claridge, A.W.""",1990,2008,18
664,"Czornij, K.","collector.Czornij, K.",1115,"collector:""Czornij, K.""",1966,1985,19
665,"Lander, N.S.","collector.Lander, N.S.",1115,"collector:""Lander, N.S.""",1951,1998,47
666,"Brown, A.","collector.Brown, A.",1112,"collector:""Brown, A.""",1918,2017,99
667,"Hansen, N.A.","collector.Hansen, N.A.",1105,"collector:""Hansen, N.A.""",1924,1966,42
668,"Keighery, B.J. | Gibson, N.","collector.Keighery, B.J. | Gibson, N.",1102,"collector:""Keighery, B.J. | Gibson, N.""",1990,1997,7
669,"Horsfall, P.","collector.Horsfall, P.",1101,"collector:""Horsfall, P.""",1991,2020,29
670,"Cherry, W.A.","collector.Cherry, W.A.",1095,"collector:""Cherry, W.A.""",1985,2016,31
671,"Vickery, J.","collector.Vickery, J.",1093,"collector:""Vickery, J.""",1886,1976,90
672,"Woolcock, C.E.","collector.Woolcock, C.E.",1092,"collector:""Woolcock, C.E.""",1972,1988,16
673,"Branwhite, P.","collector.Branwhite, P.",1091,"collector:""Branwhite, P.""",1986,2005,19
674,"Nordenstam, B. | Anderberg, A.","collector.Nordenstam, B. | Anderberg, A.",1091,"collector:""Nordenstam, B. | Anderberg, A.""",1989,1989,0
675,"Goy, D.A.","collector.Goy, D.A.",1089,"collector:""Goy, D.A.""",1934,1978,44
676,"Baker, W.R.A.","collector.Baker, W.R.A.",1077,"collector:""Baker, W.R.A.""",1871,1989,118
677,"Burns, A.C.","collector.Burns, A.C.",1077,"collector:""Burns, A.C.""",1959,1984,25
678,"Drummond, J.","collector.Drummond, J.",1077,"collector:""Drummond, J.""",1784,1970,186
679,"O'Leary, M.C.","collector.O'Leary, M.C.",1077,"collector:""O'Leary, M.C.""",1984,2016,32
680,"Scarth-Johnson, V.","collector.Scarth-Johnson, V.",1076,"collector:""Scarth-Johnson, V.""",1965,1991,26
681,"Telford, I.R.H.","collector.Telford, I.R.H.",1076,"collector:""Telford, I.R.H.""",1967,2011,44
682,"Fraser, L.R.","collector.Fraser, L.R.",1074,"collector:""Fraser, L.R.""",1907,1983,76
683,"Harvey, W.H.","collector.Harvey, W.H.",1073,"collector:""Harvey, W.H.""",1849,1954,105
684,"Heatwole, H.","collector.Heatwole, H.",1073,"collector:""Heatwole, H.""",1967,1990,23
685,"Mangion, C.","collector.Mangion, C.",1070,"collector:""Mangion, C.""",1994,2006,12
686,"Cranfield, R.J. | Knight, K.","collector.Cranfield, R.J. | Knight, K.",1065,"collector:""Cranfield, R.J. | Knight, K.""",2002,2003,1
687,"Miles, J.","collector.Miles, J.",1060,"collector:""Miles, J.""",1931,2019,88
688,"Rankin, M.O.","collector.Rankin, M.O.",1060,"collector:""Rankin, M.O.""",1975,2000,25
689,"Fryxell, P.A.","collector.Fryxell, P.A.",1059,"collector:""Fryxell, P.A.""",1983,1993,10
690,"Cooper, W.","collector.Cooper, W.",1056,"collector:""Cooper, W.""",1963,2018,55
691,"Watson, J.E.","collector.Watson, J.E.",1056,"collector:""Watson, J.E.""",1960,2005,45
692,"McKie, E.N.","collector.McKie, E.N.",1054,"collector:""McKie, E.N.""",1914,1950,36
693,"Pryor, L.D.","collector.Pryor, L.D.",1054,"collector:""Pryor, L.D.""",1924,1997,73
694,"Jackson, S.W.","collector.Jackson, S.W.",1053,"collector:""Jackson, S.W.""",1899,1992,93
695,"Milne, J.","collector.Milne, J.",1053,"collector:""Milne, J.""",1986,2016,30
696,"Scrymgeour, E.M.","collector.Scrymgeour, E.M.",1053,"collector:""Scrymgeour, E.M.""",1963,1971,8
697,"Bufton, J.","collector.Bufton, J.",1050,"collector:""Bufton, J.""",1853,1898,45
698,"Gibbons, P.","collector.Gibbons, P.",1050,"collector:""Gibbons, P.""",1981,2003,22
699,"Tyson, P.A.","collector.Tyson, P.A.",1049,"collector:""Tyson, P.A.""",2004,2016,12
700,"Robinson, C.","collector.Robinson, C.",1048,"collector:""Robinson, C.""",1916,1999,83
701,"Ashby, E.","collector.Ashby, E.",1047,"collector:""Ashby, E.""",1861,2018,157
702,"Paust, S.","collector.Paust, S.",1047,"collector:""Paust, S.""",1969,1977,8
703,"Howitt, A.W.","collector.Howitt, A.W.",1044,"collector:""Howitt, A.W.""",1838,1976,138
704,"Downey, P.O.","collector.Downey, P.O.",1041,"collector:""Downey, P.O.""",1995,2004,9
705,"Stanley, T.","collector.Stanley, T.",1041,"collector:""Stanley, T.""",1950,1995,45
706,"Whinray, J.","collector.Whinray, J.",1041,"collector:""Whinray, J.""",1965,2014,49
707,"Pritzel, E.","collector.Pritzel, E.",1038,"collector:""Pritzel, E.""",1900,1991,91
708,"Keighery, B.J.","collector.Keighery, B.J.",1035,"collector:""Keighery, B.J.""",1984,2008,24
709,"Young, A.M.","collector.Young, A.M.",1035,"collector:""Young, A.M.""",1966,2009,43
710,"Brooker, M.I.","collector.Brooker, M.I.",1034,"collector:""Brooker, M.I.""",1966,1995,29
711,"Brittan, N.H.","collector.Brittan, N.H.",1033,"collector:""Brittan, N.H.""",1950,1988,38
712,"Taylor, J.M.","collector.Taylor, J.M.",1033,"collector:""Taylor, J.M.""",1972,1991,19
713,"Cronin, M.","collector.Cronin, M.",1031,"collector:""Cronin, M.""",1887,1982,95
714,"Bishop, A.D.","collector.Bishop, A.D.",1029,"collector:""Bishop, A.D.""",1973,1995,22
715,"Unwin, G.L.","collector.Unwin, G.L.",1027,"collector:""Unwin, G.L.""",1971,1988,17
716,"Kilgour, R.A.","collector.Kilgour, R.A.",1026,"collector:""Kilgour, R.A.""",1981,1992,11
717,"Bostock, P.D.","collector.Bostock, P.D.",1024,"collector:""Bostock, P.D.""",1981,2014,33
718,"Deane, H.","collector.Deane, H.",1024,"collector:""Deane, H.""",1870,1990,120
719,"Adair, R.J.","collector.Adair, R.J.",1023,"collector:""Adair, R.J.""",1928,2016,88
720,"Nicolle, D. | French, M.","collector.Nicolle, D. | French, M.",1023,"collector:""Nicolle, D. | French, M.""",1993,2015,22
721,"Crayn, D.M.","collector.Crayn, D.M.",1022,"collector:""Crayn, D.M.""",1984,2018,34
722,"Croft, J.R.","collector.Croft, J.R.",1022,"collector:""Croft, J.R.""",1948,2010,62
723,"Sewell, J.","collector.Sewell, J.",1022,"collector:""Sewell, J.""",1882,1972,90
724,"Olsen, I.","collector.Olsen, I.",1021,"collector:""Olsen, I.""",1906,2017,111
725,"Armstrong, P.G.","collector.Armstrong, P.G.",1017,"collector:""Armstrong, P.G.""",1984,2014,30
726,A.G. Gunness et al.,collector.A.G. Gunness et al.,1012,"collector:""A.G. Gunness et al.""",1996,2001,5
727,"Crowley, V.","collector.Crowley, V.",1011,"collector:""Crowley, V.""",1984,2001,17
728,"Dahl, E.","collector.Dahl, E.",1011,"collector:""Dahl, E.""",1960,1970,10
729,"Armitage, I.B.","collector.Armitage, I.B.",1010,"collector:""Armitage, I.B.""",1962,1987,25
730,"Reid, J.C.","collector.Reid, J.C.",1009,"collector:""Reid, J.C.""",1974,2011,37
731,"Banks, J.","collector.Banks, J.",1007,"collector:""Banks, J.""",1770,1993,223
732,"Duncan, B.D.","collector.Duncan, B.D.",1005,"collector:""Duncan, B.D.""",1972,1997,25
733,"Thies, A.W.","collector.Thies, A.W.",1005,"collector:""Thies, A.W.""",1978,1998,20
734,"Milligan, J.","collector.Milligan, J.",1002,"collector:""Milligan, J.""",1807,1988,181
735,"Dwyer, J.W.","collector.Dwyer, J.W.",998,"collector:""Dwyer, J.W.""",1904,1958,54
736,"Pellow, B.","collector.Pellow, B.",997,"collector:""Pellow, B.""",1982,2016,34
737,"Allan, K.M.","collector.Allan, K.M.",996,"collector:""Allan, K.M.""",1871,1978,107
738,"Meissner, R. | Coppen, R.","collector.Meissner, R. | Coppen, R.",995,"collector:""Meissner, R. | Coppen, R.""",2011,2011,0
739,"Batianoff, G.","collector.Batianoff, G.",992,"collector:""Batianoff, G.""",1967,2009,42
740,"Hooker, N.B.","collector.Hooker, N.B.",990,"collector:""Hooker, N.B.""",2001,2020,19
741,"Mollemans, F.H.","collector.Mollemans, F.H.",987,"collector:""Mollemans, F.H.""",1981,2003,22
742,"de Beuzeville, W.A.W.","collector.de Beuzeville, W.A.W.",986,"collector:""de Beuzeville, W.A.W.""",1839,1993,154
743,"Dowe, J.L.","collector.Dowe, J.L.",985,"collector:""Dowe, J.L.""",1993,2017,24
744,"Sullivan, D.J.","collector.Sullivan, D.J.",985,"collector:""Sullivan, D.J.""",1869,1897,28
745,"Walters, N.E.M.","collector.Walters, N.E.M.",980,"collector:""Walters, N.E.M.""",1947,1976,29
746,"McDonald, K.R. (1)","collector.McDonald, K.R. (1)",972,"collector:""McDonald, K.R. (1)""",1990,2016,26
747,"Reid, W.S.","collector.Reid, W.S.",969,"collector:""Reid, W.S.""",1929,1971,42
748,"Holtze, M.W.","collector.Holtze, M.W.",965,"collector:""Holtze, M.W.""",1867,1911,44
749,"Tonkin, J.E.","collector.Tonkin, J.E.",965,"collector:""Tonkin, J.E.""",1994,2006,12
750,"Brett, R.G.","collector.Brett, R.G.",964,"collector:""Brett, R.G.""",1934,1951,17
751,"Horn, J.W.","collector.Horn, J.W.",964,"collector:""Horn, J.W.""",1999,2001,2
752,"Chapman, A.D.","collector.Chapman, A.D.",957,"collector:""Chapman, A.D.""",1961,1989,28
753,Adams,collector.Adams,952,"collector:""Adams""",1904,1973,69
754,"Paget, A.","collector.Paget, A.",952,"collector:""Paget, A.""",1934,2011,77
755,"Healey, K.","collector.Healey, K.",950,"collector:""Healey, K.""",1953,1963,10
756,"Alcock, K.M.","collector.Alcock, K.M.",949,"collector:""Alcock, K.M.""",1963,2001,38
757,"Stacey, C.I.","collector.Stacey, C.I.",949,"collector:""Stacey, C.I.""",1971,1991,20
758,"French Jnr, C.H.","collector.French Jnr, C.H.",948,"collector:""French Jnr, C.H.""",1866,1944,78
759,"Winterhalder, E.K.","collector.Winterhalder, E.K.",948,"collector:""Winterhalder, E.K.""",1950,1999,49
760,"Bancroft, T.L.","collector.Bancroft, T.L.",946,"collector:""Bancroft, T.L.""",1855,1948,93
761,"Clarke, S.","collector.Clarke, S.",943,"collector:""Clarke, S.""",1911,2017,106
762,"D'Aubert, G.","collector.D'Aubert, G.",942,"collector:""D'Aubert, G.""",1981,2004,23
763,"Nicholson, D.I.","collector.Nicholson, D.I.",942,"collector:""Nicholson, D.I.""",1940,2001,61
764,"Rohrlach, K.D.","collector.Rohrlach, K.D.",942,"collector:""Rohrlach, K.D.""",1956,1997,41
765,"Stoddart, D.R.","collector.Stoddart, D.R.",942,"collector:""Stoddart, D.R.""",1973,1974,1
766,"Hunter, W.","collector.Hunter, W.",941,"collector:""Hunter, W.""",1896,1964,68
767,"Ohlsen, D.J.","collector.Ohlsen, D.J.",941,"collector:""Ohlsen, D.J.""",2006,2019,13
768,"White, P.J.","collector.White, P.J.",941,"collector:""White, P.J.""",1985,2015,30
769,"Aberdeen, J.E.","collector.Aberdeen, J.E.",937,"collector:""Aberdeen, J.E.""",1950,1989,39
770,"Sweedman, L.","collector.Sweedman, L.",933,"collector:""Sweedman, L.""",1972,2014,42
771,"Birch, W.R.","collector.Birch, W.R.",931,"collector:""Birch, W.R.""",1960,1984,24
772,"Piesse, A.D.J.","collector.Piesse, A.D.J.",931,"collector:""Piesse, A.D.J.""",1980,1993,13
773,"Beauglehole, A.C. | Errey, E.G.","collector.Beauglehole, A.C. | Errey, E.G.",926,"collector:""Beauglehole, A.C. | Errey, E.G.""",1975,1982,7
774,"Paterson, B.R.","collector.Paterson, B.R.",926,"collector:""Paterson, B.R.""",1950,1968,18
775,"Robinson, A.","collector.Robinson, A.",924,"collector:""Robinson, A.""",1931,2009,78
776,"Rutherford, S.","collector.Rutherford, S.",924,"collector:""Rutherford, S.""",1963,2016,53
777,"Reader, E.","collector.Reader, E.",923,"collector:""Reader, E.""",1838,1894,56
778,"Foreman, P.","collector.Foreman, P.",922,"collector:""Foreman, P.""",1925,2016,91
779,"Fox, M.","collector.Fox, M.",922,"collector:""Fox, M.""",1977,1997,20
780,"Melzer, R.","collector.Melzer, R.",916,"collector:""Melzer, R.""",1992,2018,26
781,"Whitelegge, T.W.","collector.Whitelegge, T.W.",916,"collector:""Whitelegge, T.W.""",1844,1985,141
782,"Metcalfe, P.","collector.Metcalfe, P.",915,"collector:""Metcalfe, P.""",1961,2005,44
783,"Cassis, G.","collector.Cassis, G.",914,"collector:""Cassis, G.""",1996,2009,13
784,"Davies, R.","collector.Davies, R.",914,"collector:""Davies, R.""",1928,2012,84
785,"Stuckey, B.","collector.Stuckey, B.",914,"collector:""Stuckey, B.""",1965,2012,47
786,"Burbidge, A.H.","collector.Burbidge, A.H.",913,"collector:""Burbidge, A.H.""",1875,1998,123
787,"Tryon, H.","collector.Tryon, H.",913,"collector:""Tryon, H.""",1882,1983,101
788,"Rich, M.","collector.Rich, M.",911,"collector:""Rich, M.""",2008,2011,3
789,"Johnson, S.","collector.Johnson, S.",902,"collector:""Johnson, S.""",1872,2015,143
790,"Lazarides, M. | Palmer, J.","collector.Lazarides, M. | Palmer, J.",902,"collector:""Lazarides, M. | Palmer, J.""",1983,1988,5
791,"Shoobridge, D.W.","collector.Shoobridge, D.W.",901,"collector:""Shoobridge, D.W.""",1953,1981,28
792,"Weber, W.A.","collector.Weber, W.A.",901,"collector:""Weber, W.A.""",1964,1987,23
793,"Mullins, E.","collector.Mullins, E.",900,"collector:""Mullins, E.""",1971,1990,19
794,"Barker, W.R. | Barker, R.M.","collector.Barker, W.R. | Barker, R.M.",899,"collector:""Barker, W.R. | Barker, R.M.""",1979,2003,24
795,"Sands, V.E.","collector.Sands, V.E.",899,"collector:""Sands, V.E.""",1961,1984,23
796,"Sherwood, M.","collector.Sherwood, M.",899,"collector:""Sherwood, M.""",1970,1997,27
797,"Weindorfer, G.","collector.Weindorfer, G.",899,"collector:""Weindorfer, G.""",1891,1942,51
798,"Kajewski, S.F.","collector.Kajewski, S.F.",897,"collector:""Kajewski, S.F.""",1922,1992,70
799,"Wilson, K.","collector.Wilson, K.",897,"collector:""Wilson, K.""",1933,2013,80
800,"Porteners, M.F.","collector.Porteners, M.F.",896,"collector:""Porteners, M.F.""",1989,2018,29
801,"Wardell-Johnson, G.","collector.Wardell-Johnson, G.",894,"collector:""Wardell-Johnson, G.""",1897,2008,111
802,"Bishop, W.","collector.Bishop, W.",893,"collector:""Bishop, W.""",1981,1988,7
803,"Burgman, M.A. | McNee, S.","collector.Burgman, M.A. | McNee, S.",892,"collector:""Burgman, M.A. | McNee, S.""",1980,1984,4
804,"Burns, R.","collector.Burns, R.",891,"collector:""Burns, R.""",1977,1995,18
805,"Hore-Lacy, I.","collector.Hore-Lacy, I.",889,"collector:""Hore-Lacy, I.""",1902,1970,68
806,"Whiffin, T.","collector.Whiffin, T.",889,"collector:""Whiffin, T.""",1971,1990,19
807,"Wills, R.T.","collector.Wills, R.T.",889,"collector:""Wills, R.T.""",1980,2000,20
808,"Benwell, A.S.","collector.Benwell, A.S.",888,"collector:""Benwell, A.S.""",1973,2017,44
809,"Chapman, C.","collector.Chapman, C.",884,"collector:""Chapman, C.""",1954,1985,31
810,"Meissner, R. | Bayliss, B.","collector.Meissner, R. | Bayliss, B.",884,"collector:""Meissner, R. | Bayliss, B.""",2006,2013,7
811,"Brooks, S.T.","collector.Brooks, S.T.",882,"collector:""Brooks, S.T.""",1873,1899,26
812,"Trenowden, D.","collector.Trenowden, D.",881,"collector:""Trenowden, D.""",1997,1997,0
813,"Carne, W.M.","collector.Carne, W.M.",880,"collector:""Carne, W.M.""",1900,1971,71
814,K. Zosky et al.,collector.K. Zosky et al.,879,"collector:""K. Zosky et al.""",2006,2009,3
815,"Breakwell, E.","collector.Breakwell, E.",878,"collector:""Breakwell, E.""",1892,1930,38
816,"Atkins, K.J.","collector.Atkins, K.J.",877,"collector:""Atkins, K.J.""",1976,1990,14
817,"North, A.J.","collector.North, A.J.",873,"collector:""North, A.J.""",1992,2019,27
818,"Jackes, E.M.","collector.Jackes, E.M.",869,"collector:""Jackes, E.M.""",1958,2008,50
819,"Young, A.","collector.Young, A.",867,"collector:""Young, A.""",1909,2007,98
820,"Wapstra, J.E.","collector.Wapstra, J.E.",865,"collector:""Wapstra, J.E.""",1991,2012,21
821,"White, K.J.","collector.White, K.J.",865,"collector:""White, K.J.""",1929,1965,36
822,"Cheal, D.C.","collector.Cheal, D.C.",861,"collector:""Cheal, D.C.""",1973,2012,39
823,"Engel, J.J.","collector.Engel, J.J.",860,"collector:""Engel, J.J.""",1976,1983,7
824,"Smith, J.M.B.","collector.Smith, J.M.B.",857,"collector:""Smith, J.M.B.""",1970,2015,45
825,"Black, E.C.","collector.Black, E.C.",852,"collector:""Black, E.C.""",1849,1961,112
826,"Eckert, J.P.","collector.Eckert, J.P.",852,"collector:""Eckert, J.P.""",1861,1906,45
827,"Christensen, T.J.","collector.Christensen, T.J.",851,"collector:""Christensen, T.J.""",1964,2000,36
828,"Miller, J.","collector.Miller, J.",850,"collector:""Miller, J.""",1880,2016,136
829,"Ducker, S.C.","collector.Ducker, S.C.",849,"collector:""Ducker, S.C.""",1933,2019,86
830,"Higginson, A.R.R.","collector.Higginson, A.R.R.",848,"collector:""Higginson, A.R.R.""",1939,1966,27
831,"Smith, T.","collector.Smith, T.",845,"collector:""Smith, T.""",1900,2017,117
832,"Duval, D.J.","collector.Duval, D.J.",843,"collector:""Duval, D.J.""",2004,2016,12
833,"Garnett, S.T.","collector.Garnett, S.T.",843,"collector:""Garnett, S.T.""",1979,1995,16
834,"Bratt, G.C.|Bratt, M.H.","collector.Bratt, G.C.|Bratt, M.H.",841,"collector:""Bratt, G.C.|Bratt, M.H.""",1963,1973,10
835,"D'Arnay, E.","collector.D'Arnay, E.",839,"collector:""D'Arnay, E.""",1932,1977,45
836,"Slee, A.","collector.Slee, A.",837,"collector:""Slee, A.""",1973,2003,30
837,"Wyatt, R. | Stoneburner, A.","collector.Wyatt, R. | Stoneburner, A.",835,"collector:""Wyatt, R. | Stoneburner, A.""",1971,1994,23
838,"Anway, J.C.","collector.Anway, J.C.",834,"collector:""Anway, J.C.""",1954,1985,31
839,"Haegi, L.A.R.","collector.Haegi, L.A.R.",834,"collector:""Haegi, L.A.R.""",1945,1993,48
840,"Jones, D.","collector.Jones, D.",834,"collector:""Jones, D.""",1878,2017,139
841,"Jackes, B.","collector.Jackes, B.",833,"collector:""Jackes, B.""",1963,2011,48
842,"Bateman, W.","collector.Bateman, W.",831,"collector:""Bateman, W.""",1950,1986,36
843,"Johnstone, R.","collector.Johnstone, R.",831,"collector:""Johnstone, R.""",1878,2014,136
844,"Bell, A.W.","collector.Bell, A.W.",830,"collector:""Bell, A.W.""",1917,1997,80
845,"De Nardi, J.C.","collector.De Nardi, J.C.",830,"collector:""De Nardi, J.C.""",1941,2001,60
846,"Thomas, R.","collector.Thomas, R.",830,"collector:""Thomas, R.""",1973,2016,43
847,"Trudgen, M.","collector.Trudgen, M.",830,"collector:""Trudgen, M.""",1971,2015,44
848,"Waterhouse, B.","collector.Waterhouse, B.",830,"collector:""Waterhouse, B.""",1952,2014,62
849,"Sage, L.W.","collector.Sage, L.W.",829,"collector:""Sage, L.W.""",1992,2011,19
850,"Doust, A.N.L.","collector.Doust, A.N.L.",828,"collector:""Doust, A.N.L.""",1986,2001,15
851,"Brock, J.","collector.Brock, J.",827,"collector:""Brock, J.""",1983,1999,16
852,"Trapnell, W.G.","collector.Trapnell, W.G.",827,"collector:""Trapnell, W.G.""",1957,1978,21
853,"Jaques, T. | Lewis, T.","collector.Jaques, T. | Lewis, T.",826,"collector:""Jaques, T. | Lewis, T.""",2005,2009,4
854,"Pearce, R.D.","collector.Pearce, R.D.",826,"collector:""Pearce, R.D.""",1965,1997,32
855,"Harris, M.","collector.Harris, M.",825,"collector:""Harris, M.""",1958,2013,55
856,"Taplin, R.L.","collector.Taplin, R.L.",824,"collector:""Taplin, R.L.""",1987,2016,29
857,"Kraft, G.T.","collector.Kraft, G.T.",823,"collector:""Kraft, G.T.""",1964,2018,54
858,"Spencer, R.D.","collector.Spencer, R.D.",823,"collector:""Spencer, R.D.""",1969,2002,33
859,"Robinson, R.M. | Smith, R.H.","collector.Robinson, R.M. | Smith, R.H.",820,"collector:""Robinson, R.M. | Smith, R.H.""",2002,2005,3
860,"Townrow, J.E.S.","collector.Townrow, J.E.S.",819,"collector:""Townrow, J.E.S.""",1942,2001,59
861,"Phillips, G.P.","collector.Phillips, G.P.",818,"collector:""Phillips, G.P.""",2015,2019,4
862,"Davidson, D.","collector.Davidson, D.",817,"collector:""Davidson, D.""",1925,1991,66
863,"Lang, P.J. | Graham, K.L.","collector.Lang, P.J. | Graham, K.L.",817,"collector:""Lang, P.J. | Graham, K.L.""",1994,2008,14
864,"Kenny, S.D. | Carruthers, S.M.","collector.Kenny, S.D. | Carruthers, S.M.",815,"collector:""Kenny, S.D. | Carruthers, S.M.""",1998,2001,3
865,"Robinson, C.J.","collector.Robinson, C.J.",814,"collector:""Robinson, C.J.""",1980,2003,23
866,"de Salas, M.F.","collector.de Salas, M.F.",812,"collector:""de Salas, M.F.""",2011,2019,8
867,"Dalgetty, A.","collector.Dalgetty, A.",811,"collector:""Dalgetty, A.""",1993,1994,1
868,"Eaton, A.","collector.Eaton, A.",811,"collector:""Eaton, A.""",1888,2005,117
869,"Brothers, N.P.","collector.Brothers, N.P.",810,"collector:""Brothers, N.P.""",1977,1989,12
870,"Obbens, F.","collector.Obbens, F.",808,"collector:""Obbens, F.""",1993,2018,25
871,"Seabrook, J.","collector.Seabrook, J.",807,"collector:""Seabrook, J.""",1937,1997,60
872,"Giblin, A.V.","collector.Giblin, A.V.",806,"collector:""Giblin, A.V.""",1888,1939,51
873,"Basedow, H.","collector.Basedow, H.",805,"collector:""Basedow, H.""",1902,1928,26
874,"Beckler, H.","collector.Beckler, H.",805,"collector:""Beckler, H.""",1856,1933,77
875,"Rice, B.L.","collector.Rice, B.L.",803,"collector:""Rice, B.L.""",1945,2011,66
876,"Symon, D.E. | Symon, J.","collector.Symon, D.E. | Symon, J.",803,"collector:""Symon, D.E. | Symon, J.""",1997,2010,13
877,"Mollenmans, F.","collector.Mollenmans, F.",802,"collector:""Mollenmans, F.""",1961,2000,39
878,"Blackwell, M.I.","collector.Blackwell, M.I.",800,"collector:""Blackwell, M.I.""",1973,2000,27
879,"Kempe, F.A.H.","collector.Kempe, F.A.H.",800,"collector:""Kempe, F.A.H.""",1879,1924,45
880,"Burns, T.E.","collector.Burns, T.E.",798,"collector:""Burns, T.E.""",1937,1997,60
881,"Hynson, K.","collector.Hynson, K.",798,"collector:""Hynson, K.""",1984,1984,0
882,"Dornan, C.P.","collector.Dornan, C.P.",797,"collector:""Dornan, C.P.""",2007,2007,0
883,"Heinsohn, G.","collector.Heinsohn, G.",797,"collector:""Heinsohn, G.""",1966,1990,24
884,"Wapstra, H.|Wapstra, A.","collector.Wapstra, H.|Wapstra, A.",797,"collector:""Wapstra, H.|Wapstra, A.""",1992,2015,23
885,"Gibson, N. | van Leeuwen, S. | Langley, M.A. | Brown, K.","collector.Gibson, N. | van Leeuwen, S. | Langley, M.A. | Brown, K.",796,"collector:""Gibson, N. | van Leeuwen, S. | Langley, M.A. | Brown, K.""",2012,2014,2
886,"Kennedy, M.","collector.Kennedy, M.",796,"collector:""Kennedy, M.""",1911,1994,83
887,"Legge, S.","collector.Legge, S.",796,"collector:""Legge, S.""",1996,2006,10
888,"Debenham, C.","collector.Debenham, C.",794,"collector:""Debenham, C.""",1896,1972,76
889,"Newman, I.V.","collector.Newman, I.V.",794,"collector:""Newman, I.V.""",1930,1980,50
890,"Rudd, R.J.","collector.Rudd, R.J.",791,"collector:""Rudd, R.J.""",1989,1997,8
891,"Clifford, H.T.","collector.Clifford, H.T.",790,"collector:""Clifford, H.T.""",1940,2005,65
892,"Thompson, H.","collector.Thompson, H.",790,"collector:""Thompson, H.""",1887,1998,111
893,"Miller, C.H.","collector.Miller, C.H.",789,"collector:""Miller, C.H.""",1980,2012,32
894,"Patrick, S.J.","collector.Patrick, S.J.",789,"collector:""Patrick, S.J.""",1982,2017,35
895,"Dauncey, H.","collector.Dauncey, H.",788,"collector:""Dauncey, H.""",2007,2016,9
896,"Stoward, F.","collector.Stoward, F.",788,"collector:""Stoward, F.""",1879,1971,92
897,"Canty, P.D. | Heard, L.M.B.","collector.Canty, P.D. | Heard, L.M.B.",785,"collector:""Canty, P.D. | Heard, L.M.B.""",1991,1997,6
898,"McCarthy, P.M.","collector.McCarthy, P.M.",784,"collector:""McCarthy, P.M.""",1989,2019,30
899,"Sandercoe, C.","collector.Sandercoe, C.",783,"collector:""Sandercoe, C.""",1978,1994,16
900,"Pigott, J.P.","collector.Pigott, J.P.",782,"collector:""Pigott, J.P.""",1985,1996,11
901,"Baldock, R.N.","collector.Baldock, R.N.",781,"collector:""Baldock, R.N.""",1962,2017,55
902,"Errington, G.","collector.Errington, G.",780,"collector:""Errington, G.""",1992,2017,25
903,"Banks, J.C.G.","collector.Banks, J.C.G.",778,"collector:""Banks, J.C.G.""",1960,1973,13
904,"Cowan, R.S.","collector.Cowan, R.S.",777,"collector:""Cowan, R.S.""",1979,1994,15
905,"Malajczuk, N.","collector.Malajczuk, N.",776,"collector:""Malajczuk, N.""",1969,2000,31
906,"Wallace, B.J.","collector.Wallace, B.J.",775,"collector:""Wallace, B.J.""",1969,2013,44
907,"Johnson, B.","collector.Johnson, B.",774,"collector:""Johnson, B.""",1958,2014,56
908,"McMullan-Fisher, S.J.M.","collector.McMullan-Fisher, S.J.M.",774,"collector:""McMullan-Fisher, S.J.M.""",1996,2019,23
909,"Keith, D.","collector.Keith, D.",773,"collector:""Keith, D.""",1968,2012,44
910,"Muspratt, J.","collector.Muspratt, J.",772,"collector:""Muspratt, J.""",1944,1977,33
911,"Taws, N.","collector.Taws, N.",771,"collector:""Taws, N.""",1993,1995,2
912,"Wild, C.J.","collector.Wild, C.J.",770,"collector:""Wild, C.J.""",1881,1981,100
913,"Mitchell, A.S.","collector.Mitchell, A.S.",768,"collector:""Mitchell, A.S.""",1974,2017,43
914,"Holland, A.E.","collector.Holland, A.E.",764,"collector:""Holland, A.E.""",1989,2016,27
915,"Crisp, M.","collector.Crisp, M.",761,"collector:""Crisp, M.""",1965,2019,54
916,"Dalby, J.M.","collector.Dalby, J.M.",761,"collector:""Dalby, J.M.""",1984,2005,21
917,"Sutton, C.S.","collector.Sutton, C.S.",761,"collector:""Sutton, C.S.""",1804,1970,166
918,"Staer, J.","collector.Staer, J.",760,"collector:""Staer, J.""",1837,1920,83
919,"Alcock, K.","collector.Alcock, K.",759,"collector:""Alcock, K.""",1954,2007,53
920,"Kenneally, K.F. | Hyland, B.P.M.","collector.Kenneally, K.F. | Hyland, B.P.M.",758,"collector:""Kenneally, K.F. | Hyland, B.P.M.""",1963,1989,26
921,"Mallinson, D.J.","collector.Mallinson, D.J.",758,"collector:""Mallinson, D.J.""",1992,2014,22
922,"Gordon, H.D.","collector.Gordon, H.D.",757,"collector:""Gordon, H.D.""",1928,1987,59
923,"Woelkerling, W.J.","collector.Woelkerling, W.J.",757,"collector:""Woelkerling, W.J.""",1958,1997,39
924,"Bick, E.W.","collector.Bick, E.W.",756,"collector:""Bick, E.W.""",1910,1937,27
925,"Webster, M. McCallum","collector.Webster, M. McCallum",756,"collector:""Webster, M. McCallum""",1903,1982,79
926,"de Salas, M.F.|Baker, M.L.","collector.de Salas, M.F.|Baker, M.L.",756,"collector:""de Salas, M.F.|Baker, M.L.""",2011,2018,7
927,"Reid, J.","collector.Reid, J.",755,"collector:""Reid, J.""",1912,2014,102
928,"Pennay, C.","collector.Pennay, C.",754,"collector:""Pennay, C.""",1994,2016,22
929,"Start, A.N.","collector.Start, A.N.",754,"collector:""Start, A.N.""",1980,2014,34
930,"Barrett, M.D.","collector.Barrett, M.D.",752,"collector:""Barrett, M.D.""",1992,2017,25
931,"Murfet, D.E. | Lowrie, A.","collector.Murfet, D.E. | Lowrie, A.",752,"collector:""Murfet, D.E. | Lowrie, A.""",2003,2011,8
932,"Nicholls, A.","collector.Nicholls, A.",752,"collector:""Nicholls, A.""",1948,1977,29
933,"Canty, P.D. | Copley, P.B.","collector.Canty, P.D. | Copley, P.B.",751,"collector:""Canty, P.D. | Copley, P.B.""",1992,1998,6
934,"Branwhite, P.G.","collector.Branwhite, P.G.",748,"collector:""Branwhite, P.G.""",1988,2012,24
935,"Jaegermann, V.","collector.Jaegermann, V.",748,"collector:""Jaegermann, V.""",1959,1983,24
936,"Richards, A.F.","collector.Richards, A.F.",747,"collector:""Richards, A.F.""",1850,1894,44
937,D. & B. Bellairs,collector.D. & B. Bellairs,746,"collector:""D. & B. Bellairs""",1978,2004,26
938,"Halling, R.E.","collector.Halling, R.E.",746,"collector:""Halling, R.E.""",1984,2015,31
939,"Tunstall, R.G.","collector.Tunstall, R.G.",746,"collector:""Tunstall, R.G.""",1981,2005,24
940,"Ford, N.C.","collector.Ford, N.C.",744,"collector:""Ford, N.C.""",1944,1968,24
941,"Garrett, M.","collector.Garrett, M.",744,"collector:""Garrett, M.""",1947,2018,71
942,"Macey, K.","collector.Macey, K.",744,"collector:""Macey, K.""",1999,2006,7
943,"Cossalter, C.","collector.Cossalter, C.",743,"collector:""Cossalter, C.""",1972,1987,15
944,"Nordenstam, B. | Anderberg, A.A.","collector.Nordenstam, B. | Anderberg, A.A.",743,"collector:""Nordenstam, B. | Anderberg, A.A.""",1989,1989,0
945,"Cuff, N.","collector.Cuff, N.",742,"collector:""Cuff, N.""",1998,2017,19
946,"Carr, S.G.M.","collector.Carr, S.G.M.",741,"collector:""Carr, S.G.M.""",1879,1996,117
947,"Stocker, G.","collector.Stocker, G.",741,"collector:""Stocker, G.""",1959,1999,40
948,"George, A.","collector.George, A.",740,"collector:""George, A.""",1907,2007,100
949,"Salas, M.F. de","collector.Salas, M.F. de",740,"collector:""Salas, M.F. de""",2011,2016,5
950,"Ziegeler, D.","collector.Ziegeler, D.",739,"collector:""Ziegeler, D.""",1982,2011,29
951,"Fechner, N.A.","collector.Fechner, N.A.",735,"collector:""Fechner, N.A.""",2001,2015,14
952,"Ornduff, R.","collector.Ornduff, R.",735,"collector:""Ornduff, R.""",1908,1993,85
953,"Gebert, W.A.","collector.Gebert, W.A.",734,"collector:""Gebert, W.A.""",1998,2019,21
954,"Levitzke, V.J.","collector.Levitzke, V.J.",734,"collector:""Levitzke, V.J.""",1975,1983,8
955,"Randall, D.","collector.Randall, D.",733,"collector:""Randall, D.""",1979,2020,41
956,"Reeve, H.","collector.Reeve, H.",733,"collector:""Reeve, H.""",1942,1992,50
957,"Wilson, T.C.","collector.Wilson, T.C.",733,"collector:""Wilson, T.C.""",2006,2020,14
958,"Hinz, R.","collector.Hinz, R.",731,"collector:""Hinz, R.""",1974,1993,19
959,"Sparshott, K.M.","collector.Sparshott, K.M.",731,"collector:""Sparshott, K.M.""",1993,2002,9
960,"Sands, M.J.S.","collector.Sands, M.J.S.",723,"collector:""Sands, M.J.S.""",1975,2008,33
961,"Audas, J.W.C.","collector.Audas, J.W.C.",722,"collector:""Audas, J.W.C.""",1890,1935,45
962,"Redwood, K.A.","collector.Redwood, K.A.",722,"collector:""Redwood, K.A.""",1997,1997,0
963,"Turvey, F.T.","collector.Turvey, F.T.",722,"collector:""Turvey, F.T.""",1904,1969,65
964,"Weston, A.","collector.Weston, A.",722,"collector:""Weston, A.""",1891,2000,109
965,"Scott, G.A.M.","collector.Scott, G.A.M.",721,"collector:""Scott, G.A.M.""",1962,1999,37
966,"Welch, M.B.","collector.Welch, M.B.",717,"collector:""Welch, M.B.""",1896,2001,105
967,"Whaite, T.M. | Whaite, J.L.","collector.Whaite, T.M. | Whaite, J.L.",714,"collector:""Whaite, T.M. | Whaite, J.L.""",1949,1985,36
968,"Barber, H.N.","collector.Barber, H.N.",713,"collector:""Barber, H.N.""",1912,1970,58
969,"Hall, T.","collector.Hall, T.",713,"collector:""Hall, T.""",1909,2014,105
970,"Main, A.R.","collector.Main, A.R.",713,"collector:""Main, A.R.""",1939,1974,35
971,"Elick, R.","collector.Elick, R.",712,"collector:""Elick, R.""",1986,2006,20
972,"Keighery, G.J. | Keighery, B.J.","collector.Keighery, G.J. | Keighery, B.J.",712,"collector:""Keighery, G.J. | Keighery, B.J.""",1993,2019,26
973,"Webb, A. | Muir, B.","collector.Webb, A. | Muir, B.",709,"collector:""Webb, A. | Muir, B.""",2001,2001,0
974,"Griffith, H.H.D.","collector.Griffith, H.H.D.",706,"collector:""Griffith, H.H.D.""",1904,2007,103
975,"Abbott, B. | Burton, E.","collector.Abbott, B. | Burton, E.",705,"collector:""Abbott, B. | Burton, E.""",2008,2013,5
976,"May, T.W.","collector.May, T.W.",704,"collector:""May, T.W.""",1981,2018,37
977,"Barrett, R.L. | Barrett, M.D.","collector.Barrett, R.L. | Barrett, M.D.",701,"collector:""Barrett, R.L. | Barrett, M.D.""",1992,2010,18
978,"Hussey, J.L.","collector.Hussey, J.L.",697,"collector:""Hussey, J.L.""",1891,1973,82
979,"Scarlett, N.","collector.Scarlett, N.",697,"collector:""Scarlett, N.""",1947,1998,51
980,"Gill, W.","collector.Gill, W.",696,"collector:""Gill, W.""",1888,2018,130
981,"Wauchope, J.","collector.Wauchope, J.",695,"collector:""Wauchope, J.""",1923,1987,64
982,"Meissner, R. | Wright, J.","collector.Meissner, R. | Wright, J.",694,"collector:""Meissner, R. | Wright, J.""",2008,2008,0
983,"Munir, A.","collector.Munir, A.",694,"collector:""Munir, A.""",1964,1990,26
984,"Wright, G.T.","collector.Wright, G.T.",694,"collector:""Wright, G.T.""",1998,2019,21
985,"Bayer, R.J.","collector.Bayer, R.J.",693,"collector:""Bayer, R.J.""",1944,2009,65
986,"Catcheside, D.G.","collector.Catcheside, D.G.",693,"collector:""Catcheside, D.G.""",1951,1991,40
987,"Hamilton, A.G.","collector.Hamilton, A.G.",692,"collector:""Hamilton, A.G.""",1882,1992,110
988,"Ollerenshaw, N.","collector.Ollerenshaw, N.",692,"collector:""Ollerenshaw, N.""",1874,1990,116
989,"Lloyd, S.J.","collector.Lloyd, S.J.",688,"collector:""Lloyd, S.J.""",2004,2019,15
990,"Forrest, A.","collector.Forrest, A.",687,"collector:""Forrest, A.""",1818,1994,176
991,"Menkins, I.L.","collector.Menkins, I.L.",687,"collector:""Menkins, I.L.""",1998,2012,14
992,"Rodd, A.","collector.Rodd, A.",687,"collector:""Rodd, A.""",1964,1995,31
993,"Strudwick, J.","collector.Strudwick, J.",687,"collector:""Strudwick, J.""",1976,1998,22
994,"Harris, P.L.","collector.Harris, P.L.",686,"collector:""Harris, P.L.""",1981,2016,35
995,"Woolcock, C.E. | Woolcock, D.T.","collector.Woolcock, C.E. | Woolcock, D.T.",686,"collector:""Woolcock, C.E. | Woolcock, D.T.""",1968,1989,21
996,"Semple, W.","collector.Semple, W.",683,"collector:""Semple, W.""",1956,2006,50
997,"Williams, A.","collector.Williams, A.",683,"collector:""Williams, A.""",1889,2019,130
998,"Brooker, M.","collector.Brooker, M.",681,"collector:""Brooker, M.""",1960,2001,41
999,"Singh, G.","collector.Singh, G.",681,"collector:""Singh, G.""",1973,1987,14
1000,Not supplied,collector.novalue,25515,-collector:*,,,
